Admin_3,pcode_admin3,POP_Males_2012,Pop_FEMALE_2012,Total_Pop_2012,Household_No,Ave_Household_size
Bulawayo-1, ZW102101 ,5792,6466,12258,3867,3
Bulawayo-2, ZW102102 ,13164,14660,27824,7240,4
Bulawayo-3, ZW102103 ,14272,15648,29920,8018,4
Bulawayo-4, ZW102104 ,12060,13052,25112,7380,3
Bulawayo-5, ZW102105 ,8831,9926,18757,5303,4
Bulawayo-6, ZW102106 ,6223,7181,13404,3479,4
Bulawayo-7, ZW102107 ,8720,9190,17910,4802,4
Bulawayo-8, ZW102108 ,11337,12923,24260,5830,4
Bulawayo-9, ZW102109 ,13089,14747,27836,7187,4
Bulawayo-10, ZW102110 ,13772,15664,29436,7605,4
Bulawayo-11, ZW102111 ,8869,10380,19249,4697,4
Bulawayo-12, ZW102112 ,12615,14059,26674,6789,4
Bulawayo-13, ZW102113 ,9477,10286,19763,5130,4
Bulawayo-14, ZW102114 ,9556,11032,20588,5200,4
Bulawayo-15, ZW102115 ,5781,7095,12876,3089,4
Bulawayo-16, ZW102116 ,7530,9393,16923,4170,4
Bulawayo-17, ZW102117 ,8060,9207,17267,4195,4
Bulawayo-18, ZW102118 ,10502,12439,22941,5928,4
Bulawayo-19, ZW102119 ,9643,11199,20842,5275,4
Bulawayo-20, ZW102120 ,8589,10440,19029,4547,4
Bulawayo-21, ZW102121 ,13577,14896,28473,7010,4
Bulawayo-22, ZW102122 ,8779,10668,19447,4798,4
Bulawayo-23, ZW102123 ,8895,10605,19500,4909,4
Bulawayo-24, ZW102124 ,11236,12611,23847,6011,4
Bulawayo-25, ZW102125 ,11638,13349,24987,6038,4
Bulawayo-26, ZW102126 ,9622,11574,21196,5134,4
Bulawayo-27, ZW102127 ,13859,17400,31259,7450,4
Bulawayo-28, ZW102128 ,20490,24858,45348,11342,4
Bulawayo-29, ZW102129 ,8468,10281,18749,4669,4
HarareRural-1, ZW192401 ,56326,56794,113120,28691,4
Harare-2, ZW192102 ,16344,19948,36292,9300,4
Harare-3, ZW192103 ,11493,10750,22243,5727,4
Harare-4, ZW192104 ,7790,7180,14970,3926,4
Harare-5, ZW192105 ,10362,11352,21714,5782,4
Harare-6, ZW192106 ,9591,11929,21520,6761,3
Harare-7, ZW192107 ,15355,13903,29258,7925,4
Harare-8, ZW192108 ,10116,10182,20298,6698,3
Harare-9, ZW192109 ,22475,23837,46312,12379,4
Harare-10, ZW192110 ,10560,11411,21971,5571,4
Harare-11, ZW192111 ,10119,10623,20742,5061,4
Harare-12, ZW192112 ,10911,11373,22284,5380,4
Harare-13, ZW192113 ,11218,11991,23209,5438,4
Harare-14, ZW192114 ,14777,15744,30521,7890,4
Harare-15, ZW192115 ,31214,34840,66054,15787,4
Harare-16, ZW192116 ,20941,24815,45756,10978,4
Harare-17, ZW192117 ,12010,12622,24632,7599,3
Harare-18, ZW192118 ,16341,16291,32632,9980,3
Harare-19, ZW192119 ,10355,10790,21145,5164,4
Harare-20, ZW192120 ,11797,12459,24256,5950,4
Harare-21, ZW192121 ,11251,11722,22973,5662,4
Harare-22, ZW192122 ,17379,19934,37313,8624,4
Harare-23, ZW192123 ,29805,33555,63360,14485,4
Harare-24, ZW192124 ,14302,15162,29464,7846,4
Harare-25, ZW192125 ,14554,15648,30202,7955,4
Harare-26, ZW192126 ,18278,18485,36763,9689,4
Harare-27, ZW192127 ,15449,16738,32187,8048,4
Harare-28, ZW192128 ,12979,14385,27364,6502,4
Harare-29, ZW192129 ,6240,7011,13251,3268,4
Harare-30, ZW192130 ,25715,27553,53268,13551,4
Harare-31, ZW192131 ,11019,11936,22955,5738,4
Harare-32, ZW192132 ,18124,19531,37655,9534,4
Harare-33, ZW192133 ,28855,31114,59969,15232,4
Harare-34, ZW192134 ,8777,9390,18167,4366,4
Harare-35, ZW192135 ,11545,12323,23868,5695,4
Harare-36, ZW192136 ,5975,6512,12487,2848,4
Harare-37, ZW192137 ,34024,36484,70508,17616,4
Harare-38, ZW192138 ,16611,17760,34371,8658,4
Harare-39, ZW192139 ,11762,12288,24050,5871,4
Harare-40, ZW192140 ,21991,23189,45180,10922,4
Harare-41, ZW192141 ,25852,29546,55398,13706,4
Harare-42, ZW192142 ,22470,22885,45355,11658,4
Harare-43, ZW192143 ,28869,31360,60229,14831,4
Harare-44, ZW192144 ,12515,14710,27225,6286,4
Harare-45, ZW192145 ,13790,15136,28926,7135,4
Harare-46, ZW192146 ,5018,5452,10470,2548,4
Chitungwiza-1, ZW192201 ,3895,4391,8286,2075,4
Chitungwiza-2, ZW192202 ,5346,5678,11024,2924,4
Chitungwiza-3, ZW192203 ,4914,5095,10009,2565,4
Chitungwiza-4, ZW192204 ,13205,14263,27468,6912,4
Chitungwiza-5, ZW192205 ,5165,5565,10730,2791,4
Chitungwiza-6, ZW192206 ,8043,9113,17156,4087,4
Chitungwiza-7, ZW192207 ,3756,4190,7946,1844,4
Chitungwiza-8, ZW192208 ,4711,5312,10023,2263,4
Chitungwiza-9, ZW192209 ,3876,4305,8181,1925,4
Chitungwiza-10, ZW192210 ,4185,4608,8793,2080,4
Chitungwiza-11, ZW192211 ,4239,5140,9379,2227,4
Chitungwiza-12, ZW192212 ,7203,7908,15111,3690,4
Chitungwiza-13, ZW192213 ,4508,5324,9832,2398,4
Chitungwiza-14, ZW192214 ,7276,8191,15467,3708,4
Chitungwiza-15, ZW192215 ,6474,7011,13485,3378,4
Chitungwiza-16, ZW192216 ,6703,7985,14688,3961,4
Chitungwiza-17, ZW192217 ,7463,8700,16163,3733,4
Chitungwiza-18, ZW192218 ,8334,9162,17496,4328,4
Chitungwiza-19, ZW192219 ,7809,8849,16658,4042,4
Chitungwiza-20, ZW192220 ,5472,5812,11284,2864,4
Chitungwiza-21, ZW192221 ,8463,10170,18633,4369,4
Chitungwiza-22, ZW192222 ,7182,8072,15254,3787,4
Chitungwiza-23, ZW192223 ,13403,14665,28068,6910,4
Chitungwiza-24, ZW192224 ,9962,10738,20700,5161,4
Chitungwiza-25, ZW192225 ,5954,6684,12638,3081,4
Epworth-1, ZW192301 ,15905,15570,31475,8879,4
Epworth-2, ZW192302 ,7492,7404,14896,4287,4
Epworth-3, ZW192303 ,8031,7900,15931,4322,4
Epworth-4, ZW192304 ,11582,11770,23352,6074,4
Epworth-5, ZW192305 ,5804,5754,11558,3212,4
Epworth-6, ZW192306 ,12759,12838,25597,7167,4
Epworth-7, ZW192307 ,19473,19558,39031,10662,4
Buhera-1, ZW110101 ,2170,2659,4829,1156,4
Buhera-2, ZW110102 ,2110,2305,4415,1083,4
Buhera-3, ZW110103 ,2020,2374,4394,1047,4
Buhera-4, ZW110104 ,2896,3482,6378,1524,4
Buhera-5, ZW110105 ,4118,4479,8597,2151,4
Buhera-6, ZW110106 ,4106,4784,8890,2093,4
Buhera-7, ZW110107 ,2425,2825,5250,1196,4
Buhera-8, ZW110108 ,2312,2643,4955,1215,4
Buhera-9, ZW110109 ,2514,2830,5344,1254,4
Buhera-10, ZW110110 ,2691,3231,5922,1859,3
Buhera-11, ZW110111 ,3191,3752,6943,1482,5
Buhera-12, ZW110112 ,3654,4092,7746,1773,4
Buhera-13, ZW110113 ,3342,3573,6915,1608,4
Buhera-14, ZW110114 ,6414,7928,14342,3402,4
Buhera-15, ZW110115 ,4522,5448,9970,2354,4
Buhera-16, ZW110116 ,2628,2805,5433,1302,4
Buhera-17, ZW110117 ,1913,2312,4225,1000,4
Buhera-18, ZW110118 ,3191,3733,6924,1527,5
Buhera-19, ZW110119 ,2535,2941,5476,1267,4
Buhera-20, ZW110120 ,3357,3837,7194,1607,5
Buhera-21, ZW110121 ,3214,3820,7034,1570,5
Buhera-22, ZW110122 ,5858,6567,12425,2722,5
Buhera-23, ZW110123 ,5561,6294,11855,2632,5
Buhera-24, ZW110124 ,4182,4738,8920,1997,5
Buhera-25, ZW110125 ,4948,5563,10511,2334,5
Buhera-26, ZW110126 ,3431,4131,7562,1710,4
Buhera-27, ZW110127 ,3829,4244,8073,1774,5
Buhera-28, ZW110128 ,4792,5604,10396,2313,5
Buhera-29, ZW110129 ,4362,5192,9554,2146,5
Buhera-30, ZW110130 ,2049,2539,4588,1071,4
Buhera-31, ZW110131 ,2607,2970,5577,1369,4
Buhera-32, ZW110132 ,2852,3379,6231,1400,5
Buhera-33, ZW110133 ,4437,5157,9594,2188,4
Chimanimani-1, ZW110201 ,2845,2494,5339,1285,4
Chimanimani-2, ZW110202 ,1790,2048,3838,890,4
Chimanimani-3, ZW110203 ,2554,2934,5488,1322,4
Chimanimani-4, ZW110204 ,3943,4450,8393,2043,4
Chimanimani-5, ZW110205 ,3703,3341,7044,1708,4
Chimanimani-6, ZW110206 ,1149,1398,2547,648,4
Chimanimani-7, ZW110207 ,3461,3831,7292,1681,4
Chimanimani-8, ZW110208 ,4085,4665,8750,2066,4
Chimanimani-9, ZW110209 ,813,896,1709,420,4
Chimanimani-10, ZW110210 ,1185,1465,2650,634,4
Chimanimani-11, ZW110211 ,782,785,1567,418,4
Chimanimani-12, ZW110212 ,2831,2343,5174,1642,3
Chimanimani-13, ZW110213 ,5304,5738,11042,2423,5
Chimanimani-14, ZW110214 ,1851,1659,3510,1140,3
Chimanimani-15, ZW110215 ,2474,2557,5031,1451,4
Chimanimani-16, ZW110216 ,6476,6491,12967,3184,4
Chimanimani-17, ZW110217 ,2624,2908,5532,1202,5
Chimanimani-18, ZW110218 ,1192,1291,2483,624,4
Chimanimani-19, ZW110219 ,1238,1510,2748,662,4
Chimanimani-20, ZW110220 ,3304,3895,7199,1715,4
Chimanimani-21, ZW110221 ,3103,3493,6596,1577,4
Chimanimani-22, ZW110222 ,4619,5333,9952,2379,4
Chimanimani-23, ZW110223 ,3006,3953,6959,1687,4
Chipinge-1, ZW110301 ,4329,5221,9550,2351,8
Chipinge-2, ZW110302 ,4938,6076,11014,2736,8
Chipinge-3, ZW110303 ,6315,8038,14353,3441,8
Chipinge-4, ZW110304 ,4325,5346,9671,2379,8
Chipinge-5, ZW110305 ,7371,7024,14395,3467,8
Chipinge-6, ZW110306 ,7487,7965,15452,3463,9
Chipinge-7, ZW110307 ,4709,5174,9883,2441,8
Chipinge-8, ZW110308 ,8845,8877,17722,4489,8
Chipinge-9, ZW110309 ,2466,2690,5156,1054,5
Chipinge-10, ZW110310 ,2055,2031,4086,871,5
Chipinge-11, ZW110311 ,1545,1712,3257,751,4
Chipinge-12, ZW110312 ,2578,2813,5391,1501,4
Chipinge-13, ZW110313 ,2986,3234,6220,1334,5
Chipinge-14, ZW110314 ,2110,2548,4658,960,5
Chipinge-15, ZW110315 ,3180,3852,7032,1550,5
Chipinge-16, ZW110316 ,5277,6530,11807,2748,4
Chipinge-17, ZW110317 ,5615,6795,12410,2521,5
Chipinge-18, ZW110318 ,5076,5976,11052,2258,5
Chipinge-19, ZW110319 ,6127,6812,12939,2945,4
Chipinge-20, ZW110320 ,7934,10151,18085,4494,4
Chipinge-21, ZW110321 ,4117,5106,9223,1977,5
Chipinge-22, ZW110322 ,4736,5677,10413,2212,5
Chipinge-23, ZW110323 ,3974,4599,8573,1744,5
Chipinge-24, ZW110324 ,8413,10112,18525,3935,5
Chipinge-25, ZW110325 ,6230,7935,14165,2707,5
Chipinge-26, ZW110326 ,8393,9485,17878,4337,4
Chipinge-27, ZW110327 ,3049,4127,7176,1569,5
Chipinge-28, ZW110328 ,9119,10642,19761,3868,5
Chipinge-29, ZW110329 ,5973,6976,12949,2450,5
Chipinge-30, ZW110330 ,1721,1950,3671,707,5
Makoni-1, ZW110401 ,1879,2094,3973,1022,4
Makoni-2, ZW110402 ,3138,3176,6314,1492,4
Makoni-3, ZW110403 ,3969,4308,8277,2043,4
Makoni-4, ZW110404 ,255,242,497,100,5
Makoni-5, ZW110405 ,5940,6480,12420,3093,4
Makoni-6, ZW110406 ,5127,4757,9884,2257,4
Makoni-7, ZW110407 ,5660,5943,11603,2538,5
Makoni-8, ZW110408 ,6705,6568,13273,2876,5
Makoni-9, ZW110409 ,4500,4659,9159,1935,5
Makoni-10, ZW110410 ,3096,3151,6247,1357,5
Makoni-11, ZW110411 ,3792,3477,7269,1748,4
Makoni-12, ZW110412 ,5777,6326,12103,2908,4
Makoni-13, ZW110413 ,780,632,1412,345,4
Makoni-14, ZW110414 ,2635,2948,5583,1247,5
Makoni-15, ZW110415 ,3787,4303,8090,1996,4
Makoni-16, ZW110416 ,6489,6855,13344,3062,4
Makoni-17, ZW110417 ,4730,4394,9124,2135,4
Makoni-18, ZW110418 ,3039,3189,6228,1424,4
Makoni-19, ZW110419 ,2798,2902,5700,1281,4
Makoni-20, ZW110420 ,3012,3102,6114,1512,4
Makoni-21, ZW110421 ,1903,2246,4149,996,4
Makoni-22, ZW110422 ,1593,1885,3478,866,4
Makoni-23, ZW110423 ,4196,4516,8712,2081,4
Makoni-24, ZW110424 ,2873,3286,6159,1502,4
Makoni-25, ZW110425 ,3519,4074,7593,1873,4
Makoni-26, ZW110426 ,4310,4826,9136,2252,4
Makoni-27, ZW110427 ,4064,4664,8728,2065,4
Makoni-28, ZW110428 ,2137,2394,4531,1064,4
Makoni-29, ZW110429 ,1644,1898,3542,869,4
Makoni-30, ZW110430 ,3251,3521,6772,1460,5
Makoni-31, ZW110431 ,4550,4953,9503,1701,6
Makoni-32, ZW110432 ,672,734,1406,373,4
Makoni-33, ZW110433 ,1225,1246,2471,730,3
Makoni-34, ZW110434 ,1896,1981,3877,836,5
Makoni-35, ZW110435 ,4978,4913,9891,2164,5
Makoni-36, ZW110436 ,2606,2841,5447,1369,4
Makoni-37, ZW110437 ,5998,5439,11437,2961,4
Makoni-38, ZW110438 ,2741,2323,5064,1270,4
Makoni-39, ZW110439 ,2319,2460,4779,1084,4
Mutare-1, ZW110501 ,9644,9167,18811,4635,9
Mutare-2, ZW110502 ,7821,7688,15509,3612,8
Mutare-3, ZW110503 ,10148,10336,20484,4871,8
Mutare-4, ZW110504 ,5503,5896,11399,2941,8
Mutare-5, ZW110505 ,6121,6654,12775,3142,8
Mutare-6, ZW110506 ,6177,6855,13032,3007,9
Mutare-7, ZW110507 ,5715,6115,11830,2933,8
Mutare-8, ZW110508 ,3884,4573,8457,2048,9
Mutare-9, ZW110509 ,6495,7437,13932,3286,9
Mutare-10, ZW110510 ,5874,6410,12284,2672,9
Mutare-11, ZW110511 ,8165,9365,17530,4284,9
Mutare-12, ZW110512 ,9473,10863,20336,4698,9
Mutare-13, ZW110513 ,3959,3905,7864,1743,9
Mutare-14, ZW110514 ,11152,12371,23523,5856,9
Mutare-15, ZW110515 ,10747,12647,23394,5406,9
Mutare-16, ZW110516 ,17202,20381,37583,9214,8
Mutare-17, ZW110517 ,16530,18695,35225,9395,8
Mutare-18, ZW110518 ,9154,10588,19742,4782,8
Mutare-19, ZW110519 ,3880,4551,8431,1978,8
Mutare-20, ZW110520 ,2065,2375,4440,1031,4
Mutare-21, ZW110521 ,2149,2677,4826,1114,4
Mutare-22, ZW110522 ,4355,4686,9041,1986,5
Mutare-23, ZW110523 ,3126,3566,6692,1455,5
Mutare-24, ZW110524 ,4160,4566,8726,1960,5
Mutare-25, ZW110525 ,2799,3204,6003,1364,4
Mutare-26, ZW110526 ,1378,1527,2905,657,4
Mutare-27, ZW110527 ,2006,2377,4383,1076,4
Mutare-28, ZW110528 ,2730,3100,5830,1305,5
Mutare-29, ZW110529 ,4833,4981,9814,2100,5
Mutare-30, ZW110530 ,6859,5790,12649,2428,5
Mutare-31, ZW110531 ,1283,1284,2567,715,4
Mutare-32, ZW110532 ,2494,3143,5637,1321,4
Mutare-33, ZW110533 ,3804,3544,7348,2105,4
Mutare-34, ZW110534 ,7474,7093,14567,2966,5
Mutare-35, ZW110535 ,3091,3402,6493,1522,4
Mutare-36, ZW110536 ,2254,2494,4748,1050,5
Mutasa-1, ZW110601 ,4243,5126,9369,2170,4
Mutasa-2, ZW110602 ,1339,1232,2571,856,3
Mutasa-3, ZW110603 ,4257,5117,9374,2205,4
Mutasa-4, ZW110604 ,2763,3171,5934,1444,4
Mutasa-5, ZW110605 ,3442,4235,7677,1812,4
Mutasa-6, ZW110606 ,2936,3634,6570,1544,4
Mutasa-7, ZW110607 ,3963,4624,8587,2088,4
Mutasa-8, ZW110608 ,2921,3460,6381,1596,4
Mutasa-9, ZW110609 ,2468,3073,5541,1429,4
Mutasa-10, ZW110610 ,1709,2012,3721,962,4
Mutasa-11, ZW110611 ,5078,5907,10985,2680,4
Mutasa-12, ZW110612 ,2709,3299,6008,1493,4
Mutasa-13, ZW110613 ,1875,2166,4041,1023,4
Mutasa-14, ZW110614 ,1169,1393,2562,713,4
Mutasa-15, ZW110615 ,1542,1765,3307,889,4
Mutasa-16, ZW110616 ,1420,1630,3050,778,4
Mutasa-17, ZW110617 ,4825,5397,10222,2487,4
Mutasa-18, ZW110618 ,1484,1175,2659,864,3
Mutasa-19, ZW110619 ,3046,3692,6738,1702,4
Mutasa-20, ZW110620 ,2021,2304,4325,1073,4
Mutasa-21, ZW110621 ,4673,4564,9237,2377,4
Mutasa-22, ZW110622 ,1847,1713,3560,992,4
Mutasa-23, ZW110623 ,3622,3556,7178,1591,5
Mutasa-24, ZW110624 ,2058,2398,4456,1087,4
Mutasa-25, ZW110625 ,2209,2003,4212,1248,3
Mutasa-26, ZW110626 ,2779,2820,5599,1319,4
Mutasa-27, ZW110627 ,833,634,1467,427,3
Mutasa-28, ZW110628 ,1665,2053,3718,934,4
Mutasa-29, ZW110629 ,940,1105,2045,518,4
Mutasa-30, ZW110630 ,2383,2757,5140,1245,4
Mutasa-31, ZW110631 ,1606,1916,3522,933,4
Nyanga-1, ZW110701 ,2359,2565,4924,1115,4
Nyanga-2, ZW110702 ,2443,2869,5312,1256,4
Nyanga-3, ZW110703 ,2839,3293,6132,1478,4
Nyanga-4, ZW110704 ,3757,4218,7975,1978,4
Nyanga-5, ZW110705 ,2864,3123,5987,1340,5
Nyanga-6, ZW110706 ,1788,2125,3913,966,4
Nyanga-7, ZW110707 ,2000,2383,4383,1068,4
Nyanga-8, ZW110708 ,1558,1761,3319,850,4
Nyanga-9, ZW110709 ,2543,2869,5412,1352,4
Nyanga-10, ZW110710 ,1495,1839,3334,868,4
Nyanga-11, ZW110711 ,1511,1788,3299,912,4
Nyanga-12, ZW110712 ,2103,2335,4438,1071,4
Nyanga-13, ZW110713 ,1152,1399,2551,598,4
Nyanga-14, ZW110714 ,1593,1969,3562,914,4
Nyanga-15, ZW110715 ,4329,4880,9209,2132,4
Nyanga-16, ZW110716 ,1311,1310,2621,581,5
Nyanga-17, ZW110717 ,1861,2171,4032,1076,4
Nyanga-18, ZW110718 ,1845,2248,4093,1149,4
Nyanga-19, ZW110719 ,1742,2092,3834,926,4
Nyanga-20, ZW110720 ,2001,1141,3142,1365,2
Nyanga-21, ZW110721 ,2754,3256,6010,1474,4
Nyanga-22, ZW110722 ,1348,1594,2942,778,4
Nyanga-23, ZW110723 ,2911,2723,5634,1210,5
Nyanga-24, ZW110724 ,1034,939,1973,585,3
Nyanga-25, ZW110725 ,1315,1192,2507,925,3
Nyanga-26, ZW110726 ,1571,1119,2690,998,3
Nyanga-27, ZW110727 ,1097,1144,2241,552,4
Nyanga-28, ZW110728 ,351,268,619,196,3
Nyanga-29, ZW110729 ,2097,2348,4445,1359,3
Nyanga-30, ZW110730 ,1429,1633,3062,748,4
Nyanga-31, ZW110731 ,1020,1073,2093,539,4
Rusape-1, ZW112201 ,2007,2459,4466,1113,4
Rusape-2, ZW112202 ,654,779,1433,410,4
Rusape-3, ZW112203 ,674,728,1402,388,4
Rusape-4, ZW112204 ,1359,1522,2881,813,4
Rusape-5, ZW112205 ,995,1149,2144,547,4
Rusape-6, ZW112206 ,2829,3201,6030,1675,4
Rusape-7, ZW112207 ,373,460,833,227,4
Rusape-8, ZW112208 ,2205,2627,4832,1414,3
Rusape-9, ZW112209 ,1520,1783,3303,859,4
Rusape-10, ZW112210 ,1657,1737,3394,855,4
Bindura-1, ZW120101 ,4554,4619,9173,2225,9
Bindura-2, ZW120102 ,5134,4834,9968,2156,9
Bindura-3, ZW120103 ,5090,4831,9921,2168,9
Bindura-4, ZW120104 ,4581,4546,9127,2148,9
Bindura-5, ZW120105 ,4295,4387,8682,2099,8
Bindura-6, ZW120106 ,5096,4836,9932,2439,8
Bindura-7, ZW120107 ,3812,3760,7572,1751,8
Bindura-8, ZW120108 ,4604,4801,9405,2255,9
Bindura-9, ZW120109 ,4522,4805,9327,2248,8
Bindura-10, ZW120110 ,5225,5660,10885,2572,8
Bindura-11, ZW120111 ,3306,3603,6909,1601,8
Bindura-12, ZW120112 ,5580,6022,11602,2896,8
Bindura-13, ZW120113 ,1616,1638,3254,760,4
Bindura-14, ZW120114 ,1960,2201,4161,961,4
Bindura-15, ZW120115 ,2580,2854,5434,1329,4
Bindura-16, ZW120116 ,4032,4530,8562,2071,4
Bindura-17, ZW120117 ,2740,2982,5722,1366,4
Bindura-18, ZW120118 ,1754,1960,3714,894,4
Bindura-19, ZW120119 ,3670,3583,7253,1672,4
Bindura-20, ZW120120 ,3848,3702,7550,1840,4
Bindura-21, ZW120121 ,5155,4885,10040,2290,4
Centenary/ Muzarabani-1, ZW120201 ,3699,3806,7505,1594,5
Centenary/ Muzarabani-2, ZW120202 ,3175,3219,6394,1355,5
Centenary/ Muzarabani-3, ZW120203 ,1356,1404,2760,627,4
Centenary/ Muzarabani-4, ZW120204 ,2516,2623,5139,1118,5
Centenary/ Muzarabani-5, ZW120205 ,2411,2597,5008,1125,5
Centenary/ Muzarabani-6, ZW120206 ,1036,1103,2139,482,4
Centenary/ Muzarabani-7, ZW120207 ,636,661,1297,287,5
Centenary/ Muzarabani-8, ZW120208 ,2805,2905,5710,1397,4
Centenary/ Muzarabani-9, ZW120209 ,1199,1282,2481,562,4
Centenary/ Muzarabani-10, ZW120210 ,3872,4261,8133,1857,4
Centenary/ Muzarabani-11, ZW120211 ,1600,1612,3212,674,5
Centenary/ Muzarabani-12, ZW120212 ,2489,2371,4860,1164,4
Centenary/ Muzarabani-13, ZW120213 ,1474,1339,2813,639,4
Centenary/ Muzarabani-14, ZW120214 ,3605,3367,6972,1560,5
Centenary/ Muzarabani-15, ZW120215 ,1589,1761,3350,864,4
Centenary/ Muzarabani-16, ZW120216 ,841,818,1659,343,5
Centenary/ Muzarabani-17, ZW120217 ,2927,3055,5982,1352,4
Centenary/ Muzarabani-18, ZW120218 ,1126,1219,2345,493,5
Centenary/ Muzarabani-19, ZW120219 ,1451,1467,2918,664,4
Centenary/ Muzarabani-20, ZW120220 ,529,506,1035,233,4
Centenary/ Muzarabani-21, ZW120221 ,1127,1134,2261,491,5
Centenary/ Muzarabani-22, ZW120222 ,943,942,1885,415,5
Centenary/ Muzarabani-23, ZW120223 ,4853,4487,9340,1953,5
Centenary/ Muzarabani-24, ZW120224 ,2964,2974,5938,1232,5
Centenary/ Muzarabani-25, ZW120225 ,1424,1409,2833,594,5
Centenary/ Muzarabani-26, ZW120226 ,2115,1972,4087,946,4
Centenary/ Muzarabani-27, ZW120227 ,2260,2324,4584,1024,5
Centenary/ Muzarabani-28, ZW120228 ,2757,2596,5353,1219,4
Centenary/ Muzarabani-29, ZW120229 ,1447,1288,2735,579,5
Guruve-1, ZW120301 ,4502,4211,8713,1916,5
Guruve-2, ZW120302 ,2002,1840,3842,727,5
Guruve-3, ZW120303 ,936,920,1856,397,5
Guruve-4, ZW120304 ,2262,2442,4704,1044,5
Guruve-5, ZW120305 ,2645,2902,5547,1345,4
Guruve-6, ZW120306 ,3486,3902,7388,1964,4
Guruve-7, ZW120307 ,3559,4411,7970,1583,5
Guruve-8, ZW120308 ,2117,2283,4400,1011,4
Guruve-9, ZW120309 ,2552,2900,5452,1266,4
Guruve-10, ZW120310 ,2158,2310,4468,1050,4
Guruve-11, ZW120311 ,3057,3524,6581,1613,4
Guruve-12, ZW120312 ,3094,3306,6400,1556,4
Guruve-13, ZW120313 ,3253,3029,6282,1366,5
Guruve-14, ZW120314 ,2595,2293,4888,1213,4
Guruve-15, ZW120315 ,1199,1099,2298,465,5
Guruve-16, ZW120316 ,3281,3441,6722,1511,4
Guruve-17, ZW120317 ,773,776,1549,323,5
Guruve-18, ZW120318 ,2143,2245,4388,1058,4
Guruve-19, ZW120319 ,3577,3736,7313,1625,5
Guruve-20, ZW120320 ,2121,2221,4342,975,5
Guruve-21, ZW120321 ,3071,2852,5923,1198,5
Guruve-22, ZW120322 ,3464,4068,7532,1633,5
Guruve-23, ZW120323 ,1415,1389,2804,616,5
Guruve-24, ZW120324 ,1042,1063,2105,498,4
Mazowe-1, ZW120401 ,2655,3058,5713,1292,4
Mazowe-2, ZW120402 ,2192,2383,4575,1077,4
Mazowe-3, ZW120403 ,2329,2529,4858,1178,4
Mazowe-4, ZW120404 ,2089,2239,4328,1053,4
Mazowe-5, ZW120405 ,2537,2848,5385,1288,4
Mazowe-6, ZW120406 ,2660,3071,5731,1329,4
Mazowe-7, ZW120407 ,2618,2888,5506,1315,4
Mazowe-8, ZW120408 ,4713,5189,9902,2410,4
Mazowe-9, ZW120409 ,3000,3476,6476,1552,4
Mazowe-10, ZW120410 ,3133,3379,6512,1551,4
Mazowe-11, ZW120411 ,3142,3569,6711,1524,4
Mazowe-12, ZW120412 ,3723,4380,8103,1879,4
Mazowe-13, ZW120413 ,2607,2945,5552,1312,4
Mazowe-14, ZW120414 ,4283,4165,8448,1980,4
Mazowe-15, ZW120415 ,2301,2563,4864,1231,4
Mazowe-16, ZW120416 ,4047,4016,8063,1967,4
Mazowe-17, ZW120417 ,2534,2742,5276,1316,4
Mazowe-18, ZW120418 ,2792,2395,5187,1233,4
Mazowe-19, ZW120419 ,2800,5048,7848,9785,1
Mazowe-20, ZW120420 ,6260,5780,12040,3096,4
Mazowe-21, ZW120421 ,3559,3218,6777,1694,4
Mazowe-22, ZW120422 ,2425,2246,4671,1221,4
Mazowe-23, ZW120423 ,2500,2295,4795,1206,4
Mazowe-24, ZW120424 ,3582,3679,7261,1783,4
Mazowe-25, ZW120425 ,3582,3445,7027,1610,4
Mazowe-26, ZW120426 ,3239,3182,6421,1464,4
Mazowe-27, ZW120427 ,6080,5852,11932,2756,4
Mazowe-28,#N/A,1831,1734,3565,880,4
Mazowe-29, ZW120429 ,4251,4119,8370,1978,4
Mazowe-30, ZW120430 ,4285,4118,8403,1583,5
Mazowe-31, ZW120431 ,3364,3203,6567,1575,4
Mazowe-32, ZW120432 ,2629,2462,5091,1266,4
Mazowe-33, ZW120433 ,4003,4252,8255,2189,4
Mazowe-34, ZW120434 ,4620,4172,8792,2134,4
Mazowe-35, ZW120435 ,1944,1936,3880,925,6
Mount Darwin-1, ZW120501 ,1660,1769,3429,809,4
Mount Darwin-2, ZW120502 ,5882,6347,12229,2960,4
Mount Darwin-3, ZW120503 ,2205,2326,4531,1140,4
Mount Darwin-4, ZW120504 ,2039,2243,4282,1030,4
Mount Darwin-5, ZW120505 ,2206,2239,4445,1057,4
Mount Darwin-6, ZW120506 ,2460,2553,5013,1147,4
Mount Darwin-7, ZW120507 ,2621,2903,5524,1248,4
Mount Darwin-8, ZW120508 ,3769,4174,7943,1796,4
Mount Darwin-9, ZW120509 ,886,997,1883,485,4
Mount Darwin-10, ZW120510 ,4331,4608,8939,2058,4
Mount Darwin-11, ZW120511 ,2919,3217,6136,1394,4
Mount Darwin-12, ZW120512 ,2987,3321,6308,1371,5
Mount Darwin-13, ZW120513 ,749,724,1473,312,5
Mount Darwin-14, ZW120514 ,3595,4028,7623,1712,5
Mount Darwin-15, ZW120515 ,4790,5061,9851,2169,5
Mount Darwin-16, ZW120516 ,1959,2166,4125,866,5
Mount Darwin-17, ZW120517 ,3053,3369,6422,1451,4
Mount Darwin-18, ZW120518 ,3297,3435,6732,1403,5
Mount Darwin-19, ZW120519 ,4583,4363,8946,1929,5
Mount Darwin-20, ZW120520 ,2582,2659,5241,1076,5
Mount Darwin-21, ZW120521 ,410,387,797,174,5
Mount Darwin-22, ZW120522 ,4342,4338,8680,1771,5
Mount Darwin-23, ZW120523 ,3667,4214,7881,1393,6
Mount Darwin-24, ZW120524 ,4223,4449,8672,1958,4
Mount Darwin-25, ZW120525 ,707,729,1436,327,4
Mount Darwin-26, ZW120526 ,3798,4290,8088,2125,4
Mount Darwin-27, ZW120527 ,2480,2230,4710,935,5
Mount Darwin-28, ZW120528 ,537,536,1073,221,5
Mount Darwin-29, ZW120529 ,656,676,1332,272,5
Mount Darwin-30, ZW120530 ,538,508,1046,211,5
Mount Darwin-31, ZW120531 ,2102,2250,4352,973,5
Mount Darwin-32, ZW120532 ,854,937,1791,427,4
Mount Darwin-33, ZW120533 ,3259,3499,6758,1657,4
Mount Darwin-34, ZW120534 ,2607,2905,5512,1409,4
Mount Darwin-35, ZW120535 ,1919,2020,3939,875,5
Mount Darwin-36, ZW120536 ,3852,4172,8024,1850,4
Mount Darwin-37, ZW120537 ,1415,1486,2901,714,4
Mount Darwin-38, ZW120538 ,1656,1844,3500,780,5
Mount Darwin-39, ZW120539 ,2038,2057,4095,801,5
Mount Darwin-40, ZW120540 ,3437,3091,6528,1440,5
Rushinga-1, ZW120601 ,1256,1292,2548,592,4
Rushinga-2, ZW120602 ,793,791,1584,365,4
Rushinga-3, ZW120603 ,1581,1643,3224,745,4
Rushinga-4, ZW120604 ,1608,1760,3368,807,4
Rushinga-5, ZW120605 ,709,694,1403,320,4
Rushinga-6, ZW120606 ,945,996,1941,415,5
Rushinga-7, ZW120607 ,1178,1325,2503,567,4
Rushinga-8, ZW120608 ,1760,1885,3645,846,4
Rushinga-9, ZW120609 ,1494,1695,3189,684,5
Rushinga-10, ZW120610 ,1971,2109,4080,921,4
Rushinga-11, ZW120611 ,674,703,1377,325,4
Rushinga-12, ZW120612 ,1902,2074,3976,881,5
Rushinga-13, ZW120613 ,1406,1568,2974,655,5
Rushinga-14, ZW120614 ,1689,1816,3505,814,4
Rushinga-15, ZW120615 ,1664,1957,3621,875,4
Rushinga-16, ZW120616 ,1566,1776,3342,766,4
Rushinga-17, ZW120617 ,1374,1547,2921,677,4
Rushinga-18, ZW120618 ,1951,2060,4011,927,4
Rushinga-19, ZW120619 ,1192,1364,2556,659,4
Rushinga-20, ZW120620 ,1159,1194,2353,536,4
Rushinga-21, ZW120621 ,1294,1540,2834,636,5
Rushinga-22, ZW120622 ,1628,1668,3296,748,4
Rushinga-23, ZW120623 ,999,1071,2070,462,5
Rushinga-24, ZW120624 ,1428,1603,3031,858,4
Rushinga-25, ZW120625 ,582,614,1196,250,5
Shamva-1, ZW120701 ,1972,2120,4092,952,4
Shamva-2, ZW120702 ,928,1044,1972,492,4
Shamva-3, ZW120703 ,2426,2746,5172,1209,4
Shamva-4, ZW120704 ,1058,1249,2307,537,4
Shamva-5, ZW120705 ,1890,2180,4070,918,4
Shamva-6, ZW120706 ,1680,1965,3645,873,4
Shamva-7, ZW120707 ,1764,1921,3685,870,4
Shamva-8, ZW120708 ,2127,2425,4552,1068,4
Shamva-9, ZW120709 ,2789,3055,5844,1405,4
Shamva-10, ZW120710 ,1806,2087,3893,888,4
Shamva-11, ZW120711 ,2104,2325,4429,1038,4
Shamva-12, ZW120712 ,1818,1900,3718,871,4
Shamva-13, ZW120713 ,1556,1466,3022,712,4
Shamva-14, ZW120714 ,1909,1944,3853,800,5
Shamva-15, ZW120715 ,2359,2361,4720,985,5
Shamva-16, ZW120716 ,3731,3649,7380,1614,5
Shamva-17, ZW120717 ,3560,3269,6829,1478,5
Shamva-18, ZW120718 ,1707,1613,3320,740,5
Shamva-19, ZW120719 ,2190,2019,4209,983,4
Shamva-20, ZW120720 ,3384,3075,6459,1514,4
Shamva-21, ZW120721 ,1889,1511,3400,721,5
Shamva-22, ZW120722 ,2975,3250,6225,1659,4
Shamva-23, ZW120723 ,1744,1260,3004,628,5
Shamva-24, ZW120724 ,711,713,1424,368,4
Shamva-25, ZW120725 ,922,974,1896,436,4
Shamva-26, ZW120726 ,937,1038,1975,484,4
Shamva-27, ZW120727 ,1848,1792,3640,731,5
Shamva-28, ZW120728 ,1831,1734,3565,880,4
Shamva-29, ZW120729 ,3816,3414,7230,1698,4
Mbire-1, ZW120801 ,1558,1622,3180,705,5
Mbire-2, ZW120802 ,2337,2514,4851,1149,4
Mbire-3, ZW120803 ,3073,3033,6106,1337,5
Mbire-4, ZW120804 ,3529,3587,7116,1578,5
Mbire-5, ZW120805 ,2608,2681,5289,1192,4
Mbire-6, ZW120806 ,1950,2112,4062,900,5
Mbire-7, ZW120807 ,1293,1256,2549,569,5
Mbire-8, ZW120808 ,4162,4235,8397,1751,5
Mbire-9, ZW120809 ,2457,2437,4894,1126,4
Mbire-10, ZW120810 ,3414,3503,6917,1489,5
Mbire-11, ZW120811 ,829,809,1638,332,5
Mbire-12, ZW120812 ,3292,3493,6785,1509,5
Mbire-13, ZW120813 ,2820,2925,5745,1258,5
Mbire-14, ZW120814 ,1235,1174,2409,553,4
Mbire-15, ZW120815 ,2464,2698,5162,1224,4
Mbire-16, ZW120816 ,1493,1503,2996,624,5
Mbire-17, ZW120817 ,1920,1892,3812,834,5
Mvurwi-1,#N/A,595,660,1255,333,4
Mvurwi-2,#N/A,552,690,1242,313,4
Mvurwi-3,#N/A,1394,1500,2894,728,4
Mvurwi-4,#N/A,130,165,295,83,4
Mvurwi-5,#N/A,1436,1564,3000,789,4
Mvurwi-6,#N/A,864,941,1805,463,4
Chikomba-1, ZW130101 ,2311,1931,4242,1144,4
Chikomba-2, ZW130102 ,1074,841,1915,452,4
Chikomba-3, ZW130103 ,973,938,1911,418,5
Chikomba-4, ZW130104 ,1144,1148,2292,458,5
Chikomba-5, ZW130105 ,1657,1897,3554,892,4
Chikomba-6, ZW130106 ,1344,1637,2981,760,4
Chikomba-7, ZW130107 ,4281,3888,8169,1886,4
Chikomba-8, ZW130108 ,4958,4646,9604,2170,4
Chikomba-9, ZW130109 ,2434,2762,5196,1426,4
Chikomba-10, ZW130110 ,1121,1380,2501,730,3
Chikomba-11, ZW130111 ,989,1275,2264,660,3
Chikomba-12, ZW130112 ,1024,1222,2246,660,3
Chikomba-13, ZW130113 ,224,186,410,110,4
Chikomba-14, ZW130114 ,892,898,1790,394,5
Chikomba-15, ZW130115 ,2224,2476,4700,1131,4
Chikomba-16, ZW130116 ,2718,3297,6015,1530,4
Chikomba-17, ZW130117 ,3064,3595,6659,1725,4
Chikomba-18, ZW130118 ,1412,1643,3055,786,4
Chikomba-19, ZW130119 ,1470,1738,3208,805,4
Chikomba-20, ZW130120 ,2264,2557,4821,1269,4
Chikomba-21, ZW130121 ,1336,1494,2830,739,4
Chikomba-22, ZW130122 ,1606,1790,3396,864,4
Chikomba-23, ZW130123 ,2129,2501,4630,1192,4
Chikomba-24, ZW130124 ,1500,1626,3126,833,4
Chikomba-25, ZW130125 ,3283,3910,7193,1872,4
Chikomba-26, ZW130126 ,2003,2229,4232,1092,4
Chikomba-27, ZW130127 ,2816,3216,6032,1543,4
Chikomba-28, ZW130128 ,1603,1851,3454,891,4
Chikomba-29, ZW130129 ,2386,2567,4953,1330,4
Chikomba-30, ZW130130 ,1760,2023,3783,893,4
Goromonzi-1, ZW130201 ,4211,4482,8693,2054,4
Goromonzi-2, ZW130202 ,5910,6546,12456,2813,4
Goromonzi-3, ZW130203 ,2347,2574,4921,1190,4
Goromonzi-4, ZW130204 ,14465,15658,30123,7211,4
Goromonzi-5, ZW130205 ,2881,2948,5829,1325,4
Goromonzi-6, ZW130206 ,6217,5837,12054,3170,4
Goromonzi-7, ZW130207 ,2996,2918,5914,1455,4
Goromonzi-8, ZW130208 ,2880,2861,5741,1563,4
Goromonzi-9, ZW130209 ,2353,2216,4569,1265,4
Goromonzi-10, ZW130210 ,3369,3773,7142,1807,4
Goromonzi-11, ZW130211 ,4000,4501,8501,2171,4
Goromonzi-12, ZW130212 ,7007,7510,14517,3634,4
Goromonzi-13, ZW130213 ,1530,1328,2858,765,4
Goromonzi-14, ZW130214 ,4949,4744,9693,2462,4
Goromonzi-15, ZW130215 ,3289,3328,6617,1498,4
Goromonzi-16, ZW130216 ,7704,8219,15923,3751,4
Goromonzi-17, ZW130217 ,2557,2398,4955,1410,4
Goromonzi-18, ZW130218 ,3843,4031,7874,1938,4
Goromonzi-19, ZW130219 ,120,138,258,67,4
Goromonzi-20, ZW130220 ,2871,2679,5550,1470,4
Goromonzi-21, ZW130221 ,1797,1689,3486,943,4
Goromonzi-22, ZW130222 ,3772,3507,7279,1970,4
Goromonzi-23, ZW130223 ,3085,3054,6139,1559,4
Goromonzi-24, ZW130224 ,2869,3030,5899,1523,4
Goromonzi-25, ZW130225 ,13351,13537,26888,7234,4
Hwedza-1, ZW130301 ,2602,2195,4797,1144,4
Hwedza-2, ZW130302 ,4299,3795,8094,2028,4
Hwedza-3, ZW130303 ,1507,1458,2965,626,5
Hwedza-4, ZW130304 ,1621,1574,3195,723,4
Hwedza-5, ZW130305 ,3225,3529,6754,1655,4
Hwedza-6, ZW130306 ,3258,3559,6817,1726,4
Hwedza-7, ZW130307 ,3151,3532,6683,1632,4
Hwedza-8, ZW130308 ,3021,3339,6360,1567,4
Hwedza-9, ZW130309 ,3164,3493,6657,1553,4
Hwedza-10, ZW130310 ,1227,1362,2589,662,4
Hwedza-11, ZW130311 ,1635,1878,3513,891,4
Hwedza-12, ZW130312 ,1932,2185,4117,1052,4
Hwedza-13, ZW130313 ,1186,1228,2414,535,5
Hwedza-14, ZW130314 ,940,915,1855,454,4
Hwedza-15, ZW130315 ,1671,1992,3663,1025,4
Marondera-1, ZW130401 ,4372,4299,8671,2383,8
Marondera-2, ZW130402 ,3915,3923,7838,2181,8
Marondera-3, ZW130403 ,6613,6510,13123,3515,8
Marondera-4, ZW130404 ,6871,7107,13978,3614,8
Marondera-5, ZW130405 ,5708,5390,11098,3103,8
Marondera-6, ZW130406 ,5907,5839,11746,3064,8
Marondera-7, ZW130407 ,4842,4783,9625,2523,8
Marondera-8, ZW130408 ,5839,6210,12049,3113,8
Marondera-9, ZW130409 ,3161,3627,6788,1813,8
Marondera-10, ZW130410 ,5344,6090,11434,2962,8
Marondera-11, ZW130411 ,3593,3977,7570,2010,7
Marondera-12, ZW130412 ,5333,6391,11724,3038,8
Marondera-13, ZW130413 ,1716,1830,3546,882,4
Marondera-14, ZW130414 ,3262,3427,6689,1664,4
Marondera-15, ZW130415 ,2709,2701,5410,1383,4
Marondera-16, ZW130416 ,1841,2016,3857,981,4
Marondera-17, ZW130417 ,1609,1706,3315,850,4
Marondera-18, ZW130418 ,1802,1961,3763,957,4
Marondera-19, ZW130419 ,1474,1607,3081,783,4
Marondera-20, ZW130420 ,2013,2195,4208,1005,4
Marondera-21, ZW130421 ,2644,2697,5341,1304,4
Marondera-22, ZW130422 ,2173,2102,4275,926,5
Marondera-23, ZW130423 ,4803,4615,9418,2451,4
Mudzi-1, ZW130501 ,3348,3442,6790,1828,4
Mudzi-2, ZW130502 ,3736,4218,7954,2007,4
Mudzi-3, ZW130503 ,3590,3918,7508,1877,4
Mudzi-4, ZW130504 ,4093,4574,8667,2055,4
Mudzi-5, ZW130505 ,2848,3132,5980,1357,4
Mudzi-6, ZW130506 ,2765,3175,5940,1456,4
Mudzi-7, ZW130507 ,4506,5024,9530,2368,4
Mudzi-8, ZW130508 ,3041,3552,6593,1601,4
Mudzi-9, ZW130509 ,2381,2805,5186,1307,4
Mudzi-10, ZW130510 ,4269,5105,9374,2432,4
Mudzi-11, ZW130511 ,3435,4176,7611,1980,4
Mudzi-12, ZW130512 ,4622,5169,9791,2251,4
Mudzi-13, ZW130513 ,1849,2044,3893,1049,4
Mudzi-14, ZW130514 ,5919,5787,11706,2701,4
Mudzi-15, ZW130515 ,4749,5105,9854,2199,5
Mudzi-16, ZW130516 ,3195,3507,6702,1620,4
Mudzi-17, ZW130517 ,2201,2579,4780,1199,4
Mudzi-18, ZW130518 ,2309,2449,4758,1156,4
Murehwa-1, ZW130601 ,2049,2144,4193,1017,4
Murehwa-2, ZW130602 ,2035,2106,4141,990,4
Murehwa-3, ZW130603 ,2678,2757,5435,1293,4
Murehwa-4, ZW130604 ,2846,3142,5988,1757,3
Murehwa-5, ZW130605 ,1666,1948,3614,891,4
Murehwa-6, ZW130606 ,437,401,838,200,4
Murehwa-7, ZW130607 ,387,420,807,186,4
Murehwa-8, ZW130608 ,4480,4711,9191,2181,4
Murehwa-9, ZW130609 ,2135,2153,4288,992,4
Murehwa-10, ZW130610 ,2261,2535,4796,1117,4
Murehwa-11, ZW130611 ,5134,5714,10848,2463,4
Murehwa-12, ZW130612 ,4460,4893,9353,2376,4
Murehwa-13, ZW130613 ,2779,3208,5987,1442,4
Murehwa-14, ZW130614 ,3567,3946,7513,1789,4
Murehwa-15, ZW130615 ,2944,3386,6330,1557,4
Murehwa-16, ZW130616 ,3502,3929,7431,1784,4
Murehwa-17, ZW130617 ,2325,2490,4815,1081,5
Murehwa-18, ZW130618 ,1727,1869,3596,947,4
Murehwa-19, ZW130619 ,1130,1279,2409,598,4
Murehwa-20, ZW130620 ,2367,2631,4998,1256,4
Murehwa-21, ZW130621 ,2694,2966,5660,1398,4
Murehwa-22, ZW130622 ,7710,7472,15182,3372,5
Murehwa-23, ZW130623 ,5481,5277,10758,2510,4
Murehwa-24, ZW130624 ,6172,5433,11605,2687,4
Murehwa-25, ZW130625 ,2907,3161,6068,1521,4
Murehwa-26, ZW130626 ,3515,3886,7401,1767,4
Murehwa-27, ZW130627 ,4390,4843,9233,2250,4
Murehwa-28, ZW130628 ,2494,2905,5399,1330,4
Murehwa-29, ZW130629 ,2095,2439,4534,1260,4
Murehwa-30, ZW130630 ,5000,7674,12674,2667,5
Mutoko-1, ZW130701 ,2035,2152,4187,900,5
Mutoko-2, ZW130702 ,3583,3684,7267,1716,4
Mutoko-3, ZW130703 ,2104,2482,4586,1085,4
Mutoko-4, ZW130704 ,2472,2621,5093,1268,4
Mutoko-5, ZW130705 ,1992,2176,4168,1059,4
Mutoko-6, ZW130706 ,1035,1146,2181,571,4
Mutoko-7, ZW130707 ,2285,2425,4710,1233,4
Mutoko-8, ZW130708 ,1354,1428,2782,683,4
Mutoko-9, ZW130709 ,1622,1732,3354,796,4
Mutoko-10, ZW130710 ,1724,1943,3667,955,4
Mutoko-11, ZW130711 ,2228,2413,4641,1108,4
Mutoko-12, ZW130712 ,2443,2725,5168,1342,4
Mutoko-13, ZW130713 ,1466,1617,3083,758,4
Mutoko-14, ZW130714 ,2087,2201,4288,1081,4
Mutoko-15, ZW130715 ,1736,1882,3618,975,4
Mutoko-16, ZW130716 ,3187,3524,6711,1710,4
Mutoko-17, ZW130717 ,2562,2716,5278,1327,4
Mutoko-18, ZW130718 ,4054,4381,8435,2064,4
Mutoko-19, ZW130719 ,3303,3599,6902,1628,4
Mutoko-20, ZW130720 ,5794,6604,12398,3493,4
Mutoko-21, ZW130721 ,420,346,766,174,4
Mutoko-22, ZW130722 ,730,751,1481,307,5
Mutoko-23, ZW130723 ,483,467,950,245,4
Mutoko-24, ZW130724 ,450,426,876,208,4
Mutoko-25, ZW130725 ,4548,4768,9316,2086,5
Mutoko-26, ZW130726 ,3136,2983,6119,1344,5
Mutoko-27, ZW130727 ,4111,4083,8194,1809,5
Mutoko-28, ZW130728 ,2607,2784,5391,1256,4
Mutoko-29, ZW130729 ,5016,5050,10066,2191,5
Seke-1, ZW130801 ,6560,6983,13543,3224,4
Seke-2, ZW130802 ,4067,4292,8359,1993,4
Seke-3, ZW130803 ,1435,1500,2935,682,4
Seke-4, ZW130804 ,3953,4311,8264,1976,4
Seke-5, ZW130805 ,1231,1331,2562,705,4
Seke-6, ZW130806 ,1879,2001,3880,939,4
Seke-7, ZW130807 ,2236,2415,4651,1101,4
Seke-8, ZW130808 ,5112,5584,10696,2431,4
Seke-9, ZW130809 ,4739,4225,8964,2326,4
Seke-10, ZW130810 ,4567,4271,8838,2303,4
Seke-11, ZW130811 ,573,518,1091,267,4
Seke-12, ZW130812 ,2326,2069,4395,1221,4
Seke-13, ZW130813 ,1273,1357,2630,694,4
Seke-14, ZW130814 ,2040,1806,3846,1104,4
Seke-15, ZW130815 ,1792,1683,3475,867,4
Seke-16, ZW130816 ,707,705,1412,302,5
Seke-17, ZW130817 ,972,1013,1985,429,5
Seke-18, ZW130818 ,890,862,1752,409,4
Seke-19, ZW130819 ,870,804,1674,368,5
Seke-20, ZW130820 ,2581,2303,4884,1153,4
Seke-21, ZW130821 ,636,665,1301,292,5
Uzumba Maramba Pfungwe-1, ZW130901 ,3150,3273,6423,1490,4
Uzumba Maramba Pfungwe-2, ZW130902 ,2781,3062,5843,1356,4
Uzumba Maramba Pfungwe-3, ZW130903 ,2528,2771,5299,1212,4
Uzumba Maramba Pfungwe-4, ZW130904 ,4996,5220,10216,2238,5
Uzumba Maramba Pfungwe-5, ZW130905 ,2138,2440,4578,1022,5
Uzumba Maramba Pfungwe-6, ZW130906 ,3301,3539,6840,1679,4
Uzumba Maramba Pfungwe-7, ZW130907 ,1496,1476,2972,638,5
Uzumba Maramba Pfungwe-8, ZW130908 ,3456,3598,7054,1654,4
Uzumba Maramba Pfungwe-9, ZW130909 ,3582,3854,7436,1713,4
Uzumba Maramba Pfungwe-10, ZW130910 ,3193,3491,6684,1518,4
Uzumba Maramba Pfungwe-11, ZW130911 ,3791,4037,7828,1835,4
Uzumba Maramba Pfungwe-12, ZW130912 ,2935,3195,6130,1518,4
Uzumba Maramba Pfungwe-13, ZW130913 ,4212,4639,8851,2080,4
Uzumba Maramba Pfungwe-14, ZW130914 ,3546,3900,7446,1811,4
Uzumba Maramba Pfungwe-15, ZW130915 ,3363,3705,7068,1705,4
Uzumba Maramba Pfungwe-16, ZW130916 ,2846,2998,5844,1289,5
Uzumba Maramba Pfungwe-17, ZW130917 ,2685,2953,5638,1191,5
Ruwa-1, ZW132601 ,3153,3365,6518,1692,4
Ruwa-2, ZW132602 ,2514,2859,5373,1334,4
Ruwa-3, ZW132603 ,1707,2024,3731,890,4
Ruwa-4, ZW132604 ,1110,1258,2368,580,4
Ruwa-5, ZW132605 ,1075,1254,2329,569,4
Ruwa-6, ZW132606 ,1320,1576,2896,723,4
Ruwa-7, ZW132607 ,2105,2388,4493,1031,4
Ruwa-8, ZW132608 ,6355,7340,13695,3312,4
Ruwa-9, ZW132609 ,7284,7646,14930,3676,4
Chegutu-1, ZW140101 ,2771,3043,5814,1410,8
Chegutu-2, ZW140102 ,4830,5377,10207,2497,8
Chegutu-3, ZW140103 ,5197,5866,11063,2668,8
Chegutu-4, ZW140104 ,5443,5921,11364,2941,8
Chegutu-5, ZW140105 ,2500,2456,4956,1329,8
Chegutu-6, ZW140106 ,3373,3769,7142,1778,8
Chegutu-7, ZW140107 ,3384,3793,7177,1762,8
Chegutu-8, ZW140108 ,5592,6038,11630,2890,8
Chegutu-9, ZW140109 ,4234,4592,8826,2146,8
Chegutu-10, ZW140110 ,6456,7329,13785,3375,8
Chegutu-11, ZW140111 ,7493,7672,15165,3677,8
Chegutu-12, ZW140112 ,8345,8765,17110,4414,8
Chegutu-13, ZW140113 ,2053,1837,3890,960,4
Chegutu-14, ZW140114 ,2507,2305,4812,1246,4
Chegutu-15, ZW140115 ,4220,3855,8075,1983,4
Chegutu-16, ZW140116 ,864,890,1754,342,5
Chegutu-17, ZW140117 ,583,579,1162,670,2
Chegutu-18, ZW140118 ,521,489,1010,221,5
Chegutu-19, ZW140119 ,658,570,1228,278,4
Chegutu-20, ZW140120 ,3189,2972,6161,1290,5
Chegutu-21, ZW140121 ,2517,2381,4898,1216,4
Chegutu-22, ZW140122 ,4905,4560,9465,2181,4
Chegutu-23, ZW140123 ,2602,2369,4971,1150,4
Chegutu-24, ZW140124 ,3955,3449,7404,1830,4
Chegutu-25, ZW140125 ,2954,2556,5510,1193,5
Chegutu-26, ZW140126 ,1954,1733,3687,843,4
Chegutu-27, ZW140127 ,1596,1721,3317,751,4
Chegutu-28, ZW140128 ,1799,1711,3510,899,4
Chegutu-29, ZW140129 ,2001,1763,3764,1069,4
Hurungwe-1, ZW140201 ,7176,6758,13934,3242,4
Hurungwe-2, ZW140202 ,5714,5529,11243,2406,5
Hurungwe-3, ZW140203 ,5105,5182,10287,1714,6
Hurungwe-4, ZW140204 ,4349,4127,8476,1797,5
Hurungwe-5, ZW140205 ,2911,2586,5497,1265,4
Hurungwe-6, ZW140206 ,6147,5715,11862,2538,5
Hurungwe-7, ZW140207 ,6904,6587,13491,3329,4
Hurungwe-8, ZW140208 ,7636,7709,15345,3295,5
Hurungwe-9, ZW140209 ,12190,12234,24424,5407,5
Hurungwe-10, ZW140210 ,4190,4480,8670,2101,4
Hurungwe-11, ZW140211 ,7825,8366,16191,3537,5
Hurungwe-12, ZW140212 ,4503,4460,8963,1939,5
Hurungwe-13, ZW140213 ,11171,11626,22797,4840,5
Hurungwe-14, ZW140214 ,13073,13517,26590,5577,5
Hurungwe-15, ZW140215 ,3152,3240,6392,1381,5
Hurungwe-16, ZW140216 ,8107,8382,16489,3654,5
Hurungwe-17, ZW140217 ,4092,4317,8409,1822,5
Hurungwe-18, ZW140218 ,5596,5125,10721,2197,5
Hurungwe-19, ZW140219 ,4938,4637,9575,1924,5
Hurungwe-20, ZW140220 ,4108,3991,8099,1709,5
Hurungwe-21, ZW140221 ,5871,5618,11489,2458,5
Hurungwe-22, ZW140222 ,7469,7440,14909,3091,5
Hurungwe-23, ZW140223 ,4099,4055,8154,1790,5
Hurungwe-24, ZW140224 ,5622,5877,11499,2473,5
Hurungwe-25, ZW140225 ,7115,7500,14615,3141,5
Hurungwe-26, ZW140226 ,3226,3328,6554,1401,5
Mhondoro-Ngezi-1, ZW142701 ,2077,2350,4427,1069,4
Mhondoro-Ngezi-2, ZW142702 ,992,1112,2104,506,4
Mhondoro-Ngezi-3, ZW142703 ,1190,1329,2519,637,4
Mhondoro-Ngezi-4, ZW142704 ,2360,2716,5076,1241,4
Mhondoro-Ngezi-5, ZW142705 ,2945,3275,6220,1531,4
Mhondoro-Ngezi-6, ZW142706 ,2513,2772,5285,1292,4
Mhondoro-Ngezi-7, ZW142707 ,791,897,1688,406,4
Mhondoro-Ngezi-8, ZW142708 ,1414,1524,2938,681,4
Mhondoro-Ngezi-9, ZW142709 ,2512,2453,4965,1009,5
Mhondoro-Ngezi-10, ZW142710 ,1717,1652,3369,729,5
Mhondoro-Ngezi-11, ZW142711 ,10241,7798,18039,4492,4
Mhondoro-Ngezi-12, ZW142712 ,3841,3717,7558,1562,5
Mhondoro-Ngezi-13, ZW142713 ,9694,7252,16946,3664,5
Mhondoro-Ngezi-14, ZW142714 ,6478,5746,12224,2709,5
Mhondoro-Ngezi-15, ZW142715 ,2609,2495,5104,1056,5
Mhondoro-Ngezi-16, ZW142716 ,2842,2757,5599,1046,5
Kariba-1, ZW140401 ,3352,3259,6611,1763,7
Kariba-2, ZW140402 ,4712,4609,9321,2363,8
Kariba-3, ZW140403 ,5690,6097,11787,2964,8
Kariba-4, ZW140404 ,3625,3920,7545,1816,8
Kariba-5, ZW140405 ,2480,2535,5015,1157,9
Kariba-6, ZW140406 ,1779,1816,3595,848,9
Kariba-7, ZW140407 ,1209,1278,2487,618,8
Kariba-8, ZW140408 ,3465,3500,6965,1471,9
Kariba-9, ZW140409 ,2368,2261,4629,1066,9
Kariba-10, ZW140410 ,762,802,1564,349,5
Kariba-11, ZW140411 ,1248,1290,2538,530,5
Kariba-12, ZW140412 ,3181,2924,6105,1509,4
Makonde-1, ZW140501 ,4145,3781,7926,1710,5
Makonde-2, ZW140502 ,6377,6080,12457,2766,5
Makonde-3, ZW140503 ,1915,1871,3786,748,5
Makonde-4, ZW140504 ,6069,5929,11998,2586,5
Makonde-5, ZW140505 ,5321,5104,10425,2144,5
Makonde-6, ZW140506 ,3038,2786,5824,1318,4
Makonde-7, ZW140507 ,1404,1545,2949,728,4
Makonde-8, ZW140508 ,11086,11080,22166,4573,5
Makonde-9, ZW140509 ,4597,4505,9102,1865,5
Makonde-10, ZW140510 ,1515,1460,2975,671,4
Makonde-11, ZW140511 ,7726,7873,15599,3594,4
Makonde-12, ZW140512 ,925,872,1797,370,5
Makonde-13, ZW140513 ,3324,3132,6456,1388,5
Makonde-14, ZW140514 ,2404,2412,4816,1101,4
Makonde-15, ZW140515 ,2395,2371,4766,1069,5
Makonde-16, ZW140516 ,2667,2657,5324,1135,5
Makonde-17, ZW140517 ,2393,2465,4858,1088,5
Makonde-18, ZW140518 ,2760,2657,5417,1204,5
Makonde-19, ZW140519 ,5176,5002,10178,2156,5
Zvimba-1, ZW140601 ,2134,2364,4498,1070,4
Zvimba-2, ZW140602 ,1094,1239,2333,639,4
Zvimba-3, ZW140603 ,2590,2838,5428,1311,4
Zvimba-4, ZW140604 ,1324,1516,2840,654,4
Zvimba-5, ZW140605 ,1636,1854,3490,830,4
Zvimba-6, ZW140606 ,2770,2956,5726,1383,4
Zvimba-7, ZW140607 ,2577,2722,5299,1148,5
Zvimba-8, ZW140608 ,1808,2048,3856,878,4
Zvimba-9, ZW140609 ,1619,1787,3406,735,5
Zvimba-10, ZW140610 ,1080,1206,2286,540,4
Zvimba-11, ZW140611 ,1710,1875,3585,842,4
Zvimba-12, ZW140612 ,1665,1951,3616,853,4
Zvimba-13, ZW140613 ,6327,6120,12447,2759,5
Zvimba-14, ZW140614 ,3701,3516,7217,1707,4
Zvimba-15, ZW140615 ,6644,6623,13267,3265,4
Zvimba-16, ZW140616 ,868,901,1769,439,4
Zvimba-17, ZW140617 ,5594,5292,10886,2331,5
Zvimba-18, ZW140618 ,3588,3417,7005,1636,4
Zvimba-19, ZW140619 ,4791,4658,9449,2233,4
Zvimba-20, ZW140620 ,4892,4827,9719,2328,4
Zvimba-21, ZW140621 ,6416,5716,12132,2940,4
Zvimba-22, ZW140622 ,3383,3805,7188,1878,4
Zvimba-23, ZW140623 ,1507,1608,3115,704,4
Zvimba-24, ZW140624 ,4537,4424,8961,2220,4
Zvimba-25, ZW140625 ,4104,3581,7685,1933,4
Zvimba-26, ZW140626 ,8997,8968,17965,4453,4
Zvimba-27, ZW140627 ,1372,1358,2730,605,5
Zvimba-28, ZW140628 ,798,856,1654,418,4
Zvimba-29, ZW140629 ,1556,1714,3270,761,4
Zvimba-30, ZW140630 ,5118,5013,10131,2341,4
Zvimba-31, ZW140631 ,3487,3309,6796,1523,5
Zvimba-32, ZW140632 ,3836,3735,7571,1783,4
Zvimba-33, ZW140633 ,4346,4073,8419,1880,5
Zvimba-34, ZW140634 ,2841,2830,5671,1279,4
Zvimba-35, ZW140635 ,11852,12227,24079,6005,4
Sanyati-1, ZW142801 ,5016,4302,9318,2196,4
Sanyati-2, ZW142802 ,5218,4851,10069,2181,5
Sanyati-3, ZW142803 ,13903,12575,26478,6039,4
Sanyati-4, ZW142804 ,4133,4075,8208,1722,5
Sanyati-5, ZW142805 ,5528,5607,11135,2254,5
Sanyati-6, ZW142806 ,1824,1914,3738,826,5
Sanyati-7, ZW142807 ,956,996,1952,457,4
Sanyati-8, ZW142808 ,1154,1362,2516,594,4
Sanyati-9, ZW142809 ,1291,1265,2556,581,4
Sanyati-10, ZW142810 ,2573,2858,5431,1216,5
Sanyati-11, ZW142811 ,3015,3158,6173,1444,4
Sanyati-12, ZW142812 ,3283,3480,6763,1474,5
Sanyati-13, ZW142813 ,439,442,881,169,5
Sanyati-14, ZW142814 ,679,606,1285,270,5
Sanyati-15, ZW142815 ,423,469,892,184,5
Sanyati-16, ZW142816 ,3268,3143,6411,1327,5
Sanyati-17, ZW142817 ,2538,2539,5077,1042,5
Sanyati-18, ZW142818 ,2092,2245,4337,1281,3
Chinhoyi-1, ZW142101 ,4171,4569,8740,2245,8
Chinhoyi-2, ZW142102 ,5856,6333,12189,3182,8
Chinhoyi-3, ZW142103 ,6304,7408,13712,3307,8
Chinhoyi-4, ZW142104 ,5539,6243,11782,2868,8
Chinhoyi-5, ZW142105 ,6570,7433,14003,3496,8
Chinhoyi-6, ZW142106 ,5050,5727,10777,2626,8
Chinhoyi-7, ZW142107 ,4076,4539,8615,2141,8
Chinhoyi-8, ZW142108 ,7618,8812,16430,4363,8
Chinhoyi-9, ZW142109 ,2173,2205,4378,1082,8
Chinhoyi-10, ZW142110 ,4471,4645,9116,2214,8
Chinhoyi-11, ZW142111 ,5479,5608,11087,2254,11
Chinhoyi-12, ZW142112 ,4877,5479,10356,2481,8
Chinhoyi-13, ZW142113 ,4445,4943,9388,2219,8
Chinhoyi-14, ZW142114 ,5095,5232,10327,2968,7
Chinhoyi-15, ZW142115 ,4352,4830,9182,2145,8
Chinhoyi-16,#N/A,2882,2948,5830,1411,4
Chinhoyi-17,#N/A,1704,1861,3565,921,4
Norton-1, ZW142501 ,2081,2345,4426,1037,4
Norton-2, ZW142502 ,293,242,535,139,4
Norton-3, ZW142503 ,1491,1666,3157,742,4
Norton-4, ZW142504 ,3787,3969,7756,1882,4
Norton-5, ZW142505 ,1215,1310,2525,644,4
Norton-6, ZW142506 ,1120,1244,2364,583,4
Norton-7, ZW142507 ,2029,2229,4258,1060,4
Norton-8, ZW142508 ,1791,1998,3789,926,4
Norton-9, ZW142509 ,1817,1910,3727,944,4
Norton-10, ZW142510 ,1595,1865,3460,878,4
Norton-11, ZW142511 ,2599,2806,5405,1356,4
Norton-12, ZW142512 ,4304,4632,8936,2293,4
Norton-13, ZW142513 ,3816,4267,8083,1998,4
Karoi-1, ZW142601 ,1061,1296,2357,615,4
Karoi-2, ZW142602 ,528,632,1160,281,4
Karoi-3, ZW142603 ,792,1002,1794,511,4
Karoi-4, ZW142604 ,822,965,1787,486,4
Karoi-5, ZW142605 ,892,1079,1971,515,4
Karoi-6, ZW142606 ,708,878,1586,491,3
Karoi-7, ZW142607 ,962,965,1927,447,4
Karoi-8, ZW142608 ,859,945,1804,485,4
Karoi-9, ZW142609 ,916,1087,2003,511,4
Karoi-10, ZW142610 ,1074,1294,2368,619,4
Binga-1, ZW150101 ,1733,1945,3678,887,4
Binga-2, ZW150102 ,2104,2717,4821,1200,4
Binga-3, ZW150103 ,2171,2526,4697,1283,4
Binga-4, ZW150104 ,1471,1852,3323,868,4
Binga-5, ZW150105 ,1993,2524,4517,1117,4
Binga-6, ZW150106 ,2200,2713,4913,1254,4
Binga-7, ZW150107 ,2298,2860,5158,1231,4
Binga-8, ZW150108 ,1735,2051,3786,1013,4
Binga-9, ZW150109 ,2430,3031,5461,1471,4
Binga-10, ZW150110 ,1630,2223,3853,975,4
Binga-11, ZW150111 ,1548,1825,3373,874,4
Binga-12, ZW150112 ,1426,1824,3250,758,4
Binga-13, ZW150113 ,1863,2228,4091,1017,4
Binga-14, ZW150114 ,3637,4140,7777,1720,5
Binga-15, ZW150115 ,1574,2134,3708,791,5
Binga-16, ZW150116 ,4388,5049,9437,2110,5
Binga-17, ZW150117 ,4782,5560,10342,2155,5
Binga-18, ZW150118 ,2466,2751,5217,1135,5
Binga-19, ZW150119 ,2403,2780,5183,1088,5
Binga-20, ZW150120 ,1870,2261,4131,815,5
Binga-21, ZW150121 ,8310,9060,17370,3237,5
Binga-22, ZW150122 ,1405,1315,2720,658,4
Binga-23, ZW150123 ,3270,3795,7065,1569,5
Binga-24, ZW150124 ,3033,3207,6240,1570,4
Binga-25, ZW150125 ,1772,2191,3963,879,5
Bubi-1, ZW150201 ,2033,1591,3624,769,5
Bubi-2, ZW150202 ,1415,1489,2904,640,5
Bubi-3, ZW150203 ,1701,1907,3608,748,5
Bubi-4, ZW150204 ,1744,2016,3760,751,5
Bubi-5, ZW150205 ,729,754,1483,314,5
Bubi-6, ZW150206 ,90,67,157,36,4
Bubi-7, ZW150207 ,1566,1736,3302,780,4
Bubi-8, ZW150208 ,753,621,1374,318,4
Bubi-9, ZW150209 ,447,417,864,179,5
Bubi-10, ZW150210 ,1338,953,2291,623,4
Bubi-11, ZW150211 ,3827,3589,7416,2041,4
Bubi-12, ZW150212 ,1467,1287,2754,624,4
Bubi-13, ZW150213 ,1081,957,2038,511,4
Bubi-14, ZW150214 ,764,616,1380,362,4
Bubi-15, ZW150215 ,1211,1284,2495,557,5
Bubi-16, ZW150216 ,964,1002,1966,398,5
Bubi-17, ZW150217 ,1386,1472,2858,588,5
Bubi-18, ZW150218 ,1036,1102,2138,438,5
Bubi-19, ZW150219 ,1344,1201,2545,483,5
Bubi-20, ZW150220 ,2168,2025,4193,863,5
Bubi-21, ZW150221 ,2641,2549,5190,1029,5
Bubi-22, ZW150222 ,415,324,739,256,3
Bubi-23, ZW150223 ,1778,1331,3109,799,4
Hwange-1, ZW150301 ,2923,2638,5561,1325,8
Hwange-2, ZW150302 ,2537,2522,5059,1197,9
Hwange-3, ZW150303 ,2107,2158,4265,999,9
Hwange-4, ZW150304 ,2290,2390,4680,1103,8
Hwange-5, ZW150305 ,2120,2225,4345,1344,7
Hwange-6, ZW150306 ,2821,3016,5837,1520,8
Hwange-7, ZW150307 ,2151,2124,4275,983,9
Hwange-8, ZW150308 ,5648,5851,11499,2999,8
Hwange-9, ZW150309 ,997,1005,2002,489,8
Hwange-10, ZW150310 ,3290,3283,6573,1630,8
Hwange-11, ZW150311 ,3231,3347,6578,1723,8
Hwange-12, ZW150312 ,2132,2285,4417,987,8
Hwange-13, ZW150313 ,290,302,592,128,5
Hwange-14, ZW150314 ,3704,4041,7745,1848,9
Hwange-15, ZW150315 ,4787,4960,9747,2391,9
Hwange-16, ZW150316 ,1614,1868,3482,753,5
Hwange-17, ZW150317 ,1468,1726,3194,689,5
Hwange-18, ZW150318 ,1868,1882,3750,1214,3
Hwange-19, ZW150319 ,528,418,946,320,3
Hwange-20, ZW150320 ,2999,2705,5704,1154,5
Lupane-1, ZW150401 ,1265,1470,2735,537,5
Lupane-2, ZW150402 ,862,988,1850,403,5
Lupane-3, ZW150403 ,2171,2549,4720,923,5
Lupane-4, ZW150404 ,1194,1274,2468,490,5
Lupane-5, ZW150405 ,2133,2307,4440,842,5
Lupane-6, ZW150406 ,1279,1490,2769,484,6
Lupane-7, ZW150407 ,941,1072,2013,360,6
Lupane-8, ZW150408 ,1912,2040,3952,767,5
Lupane-9, ZW150409 ,1475,1547,3022,598,5
Lupane-10, ZW150410 ,2377,2655,5032,899,6
Lupane-11, ZW150411 ,2459,2681,5140,889,6
Lupane-12, ZW150412 ,1937,2023,3960,762,5
Lupane-13, ZW150413 ,2049,2256,4305,898,5
Lupane-14, ZW150414 ,1550,1695,3245,655,5
Lupane-15, ZW150415 ,2978,3193,6171,1388,4
Lupane-16, ZW150416 ,1964,2179,4143,783,5
Lupane-17, ZW150417 ,1919,2087,4006,708,6
Lupane-18, ZW150418 ,1561,1763,3324,615,5
Lupane-19, ZW150419 ,2006,2222,4228,810,5
Lupane-20, ZW150420 ,1892,2079,3971,750,5
Lupane-21, ZW150421 ,2182,2418,4600,833,6
Lupane-22, ZW150422 ,3451,3723,7174,1457,5
Lupane-23, ZW150423 ,1499,1663,3162,603,5
Lupane-24, ZW150424 ,620,663,1283,270,5
Lupane-25, ZW150425 ,761,777,1538,353,4
Lupane-26, ZW150426 ,440,429,869,179,5
Lupane-27, ZW150427 ,1646,1738,3384,646,5
Lupane-28, ZW150428 ,710,650,1360,258,5
Nkayi-1, ZW150501 ,2243,2503,4746,982,5
Nkayi-2, ZW150502 ,1982,2145,4127,733,6
Nkayi-3, ZW150503 ,1755,1854,3609,746,5
Nkayi-4, ZW150504 ,1530,1658,3188,650,5
Nkayi-5, ZW150505 ,3220,3622,6842,1285,5
Nkayi-6, ZW150506 ,2135,2454,4589,901,5
Nkayi-7, ZW150507 ,1760,1942,3702,736,5
Nkayi-8, ZW150508 ,1944,2085,4029,730,6
Nkayi-9, ZW150509 ,1141,1223,2364,426,6
Nkayi-10, ZW150510 ,1584,1623,3207,585,6
Nkayi-11, ZW150511 ,1302,1376,2678,492,5
Nkayi-12, ZW150512 ,1853,2137,3990,771,5
Nkayi-13, ZW150513 ,2087,2423,4510,843,5
Nkayi-14, ZW150514 ,1635,1651,3286,604,5
Nkayi-15, ZW150515 ,925,1001,1926,355,5
Nkayi-16, ZW150516 ,1767,1845,3612,742,5
Nkayi-17, ZW150517 ,1311,1480,2791,566,5
Nkayi-18, ZW150518 ,1450,1503,2953,553,5
Nkayi-19, ZW150519 ,1824,1885,3709,765,5
Nkayi-20, ZW150520 ,1571,1719,3290,690,5
Nkayi-21, ZW150521 ,1686,1783,3469,715,5
Nkayi-22, ZW150522 ,2674,3054,5728,1186,5
Nkayi-23, ZW150523 ,1320,1426,2746,582,5
Nkayi-24, ZW150524 ,2150,2273,4423,848,5
Nkayi-25, ZW150525 ,2044,2128,4172,772,5
Nkayi-26, ZW150526 ,1233,1456,2689,525,5
Nkayi-27, ZW150527 ,1738,1797,3535,622,6
Nkayi-28, ZW150528 ,919,1036,1955,391,5
Nkayi-29, ZW150529 ,2440,2927,5367,1243,4
Nkayi-30, ZW150530 ,1018,1121,2139,434,5
Tsholotsho-1, ZW150601 ,1834,1901,3735,747,5
Tsholotsho-2, ZW150602 ,2273,2556,4829,965,5
Tsholotsho-3, ZW150603 ,2422,2927,5349,1031,5
Tsholotsho-4, ZW150604 ,1377,1457,2834,563,5
Tsholotsho-5, ZW150605 ,2434,2748,5182,1108,5
Tsholotsho-6, ZW150606 ,3444,3897,7341,1532,5
Tsholotsho-7, ZW150607 ,2050,2178,4228,804,5
Tsholotsho-8, ZW150608 ,4103,4947,9050,1752,5
Tsholotsho-9, ZW150609 ,3087,3525,6612,1291,5
Tsholotsho-10, ZW150610 ,1594,1689,3283,731,5
Tsholotsho-11, ZW150611 ,1798,2148,3946,1159,3
Tsholotsho-12, ZW150612 ,3363,3640,7003,1471,5
Tsholotsho-13, ZW150613 ,2841,3327,6168,1411,4
Tsholotsho-14, ZW150614 ,1572,2070,3642,779,5
Tsholotsho-15, ZW150615 ,3618,4514,8132,1727,5
Tsholotsho-16, ZW150616 ,2507,3130,5637,1213,5
Tsholotsho-17, ZW150617 ,1971,2562,4533,959,5
Tsholotsho-18, ZW150618 ,2130,2418,4548,925,5
Tsholotsho-19, ZW150619 ,2610,3142,5752,1242,5
Tsholotsho-20, ZW150620 ,969,899,1868,417,5
Tsholotsho-21, ZW150621 ,1034,1262,2296,443,5
Tsholotsho-22, ZW150622 ,3598,4329,7927,1881,4
Umguza-1, ZW150701 ,2844,2705,5549,1459,4
Umguza-2, ZW150702 ,6892,5328,12220,2775,4
Umguza-3, ZW150703 ,1906,2001,3907,758,5
Umguza-4, ZW150704 ,1475,1521,2996,616,5
Umguza-5, ZW150705 ,1984,1956,3940,808,5
Umguza-6, ZW150706 ,1409,1531,2940,638,5
Umguza-7, ZW150707 ,2680,2693,5373,1465,4
Umguza-8, ZW150708 ,2747,2451,5198,1394,4
Umguza-9, ZW150709 ,2991,2635,5626,1411,4
Umguza-10, ZW150710 ,1457,1430,2887,607,5
Umguza-11, ZW150711 ,2559,2742,5301,1133,5
Umguza-12, ZW150712 ,1028,1112,2140,436,5
Umguza-13, ZW150713 ,1268,1220,2488,560,4
Umguza-14, ZW150714 ,2223,2055,4278,1077,4
Umguza-15, ZW150715 ,1683,2245,3928,388,10
Umguza-16, ZW150716 ,7244,4475,11719,2314,5
Umguza-17, ZW150717 ,415,346,761,191,4
Umguza-18, ZW150718 ,964,1041,2005,388,5
Umguza-19, ZW150719 ,2180,2082,4262,1077,4
VictoriaFalls-1, ZW152201 ,515,556,1071,327,3
VictoriaFalls-2, ZW152202 ,1602,1370,2972,506,6
VictoriaFalls-3, ZW152203 ,488,564,1052,253,4
VictoriaFalls-4, ZW152204 ,1112,1145,2257,592,4
VictoriaFalls-5, ZW152205 ,790,873,1663,476,4
VictoriaFalls-6, ZW152206 ,610,731,1341,370,4
VictoriaFalls-7, ZW152207 ,856,983,1839,500,4
VictoriaFalls-8, ZW152208 ,854,955,1809,545,3
VictoriaFalls-9, ZW152209 ,1720,1924,3644,1018,4
VictoriaFalls-10, ZW152210 ,1349,1483,2832,767,4
VictoriaFalls-11, ZW152211 ,6310,6920,13230,3755,4
Beitbridge-1, ZW160101 ,4415,5021,9436,1664,12
Beitbridge-2, ZW160102 ,3379,3734,7113,1747,8
Beitbridge-3, ZW160103 ,5242,6099,11341,2775,9
Beitbridge-4, ZW160104 ,7826,8672,16498,4631,8
Beitbridge-5, ZW160105 ,8000,9475,17475,4458,8
Beitbridge-6, ZW160106 ,9293,9803,19096,5571,7
Beitbridge-7, ZW160107 ,1324,1458,2782,591,5
Beitbridge-8, ZW160108 ,1681,2044,3725,828,5
Beitbridge-9, ZW160109 ,2313,2497,4810,1123,4
Beitbridge-10, ZW160110 ,2699,3310,6009,1199,5
Beitbridge-11, ZW160111 ,3232,3850,7082,1502,5
Beitbridge-12, ZW160112 ,2766,3192,5958,1312,5
Beitbridge-13, ZW160113 ,1279,1043,2322,611,4
Beitbridge-14, ZW160114 ,2673,1985,4658,1561,3
Beitbridge-15, ZW160115 ,1971,2277,4248,982,4
Bulilima-1, ZW160201 ,2352,2753,5105,1133,5
Bulilima-2, ZW160202 ,1206,1411,2617,591,4
Bulilima-3, ZW160203 ,2792,3301,6093,1286,5
Bulilima-4, ZW160204 ,2405,2548,4953,1098,5
Bulilima-5, ZW160205 ,2739,3276,6015,1417,4
Bulilima-6, ZW160206 ,2220,2791,5011,1172,4
Bulilima-7, ZW160207 ,3783,4591,8374,1824,5
Bulilima-8, ZW160208 ,1783,2353,4136,878,5
Bulilima-9, ZW160209 ,2455,2847,5302,1279,4
Bulilima-10, ZW160210 ,1847,2104,3951,883,5
Bulilima-11, ZW160211 ,2180,2597,4777,1013,5
Bulilima-12, ZW160212 ,2895,3573,6468,1231,5
Bulilima-13, ZW160213 ,1398,1759,3157,646,5
Bulilima-14, ZW160214 ,2674,3028,5702,1285,4
Bulilima-15, ZW160215 ,903,922,1825,367,5
Bulilima-16, ZW160216 ,924,961,1885,388,5
Bulilima-17, ZW160217 ,184,189,373,80,5
Bulilima-18, ZW160218 ,472,494,966,182,5
Bulilima-19, ZW160219 ,2977,2979,5956,1251,5
Bulilima-20, ZW160220 ,1007,1082,2089,460,5
Bulilima-21, ZW160221 ,976,1099,2075,468,4
Bulilima-22, ZW160222 ,1741,2186,3927,829,5
Mangwe-1, ZW160301 ,3158,3830,6988,1590,9
Mangwe-2, ZW160302 ,2595,3085,5680,1278,9
Mangwe-3, ZW160303 ,3683,4298,7981,1905,9
Mangwe-4, ZW160304 ,2945,3526,6471,1382,9
Mangwe-5, ZW160305 ,1825,1958,3783,948,8
Mangwe-6, ZW160306 ,3528,3987,7515,1697,9
Mangwe-7, ZW160307 ,1381,1610,2991,617,5
Mangwe-8, ZW160308 ,977,1119,2096,399,5
Mangwe-9, ZW160309 ,1035,1330,2365,498,5
Mangwe-10, ZW160310 ,2339,2765,5104,1041,5
Mangwe-11, ZW160311 ,2119,1431,3550,865,4
Mangwe-12, ZW160312 ,1302,1411,2713,562,5
Mangwe-13, ZW160313 ,1624,1777,3401,650,5
Mangwe-14, ZW160314 ,996,1114,2110,428,5
Mangwe-15, ZW160315 ,2886,2916,5802,1224,5
Mangwe-16, ZW160316 ,2664,3492,6156,1225,5
Mangwe-17, ZW160317 ,1820,2139,3959,770,5
Gwanda-1, ZW160401 ,3166,3359,6525,1480,9
Gwanda-2, ZW160402 ,2268,2531,4799,1052,9
Gwanda-3, ZW160403 ,2050,2268,4318,979,9
Gwanda-4, ZW160404 ,3329,3869,7198,1680,9
Gwanda-5, ZW160405 ,1530,1671,3201,786,9
Gwanda-6, ZW160406 ,3537,3908,7445,1725,9
Gwanda-7, ZW160407 ,3211,3837,7048,1756,9
Gwanda-8, ZW160408 ,4285,4495,8780,2237,7
Gwanda-9, ZW160409 ,3017,3271,6288,1468,9
Gwanda-10, ZW160410 ,757,564,1321,379,7
Gwanda-11, ZW160411 ,2115,2478,4593,1079,4
Gwanda-12, ZW160412 ,2315,2804,5119,1148,5
Gwanda-13, ZW160413 ,3637,4104,7741,1644,5
Gwanda-14, ZW160414 ,2646,3219,5865,1389,4
Gwanda-15, ZW160415 ,2116,2597,4713,1082,4
Gwanda-16, ZW160416 ,2530,2937,5467,1226,5
Gwanda-17, ZW160417 ,2741,3230,5971,1283,5
Gwanda-18, ZW160418 ,2532,2986,5518,1207,5
Gwanda-19, ZW160419 ,2497,2902,5399,1231,4
Gwanda-20, ZW160420 ,2106,2512,4618,968,5
Gwanda-21, ZW160421 ,4570,3242,7812,2229,4
Gwanda-22, ZW160422 ,4379,3238,7617,1966,4
Gwanda-23, ZW160423 ,3604,3119,6723,1762,4
Gwanda-24, ZW160424 ,1193,1505,2698,673,4
Insiza-1, ZW160501 ,1901,1968,3869,783,5
Insiza-2, ZW160502 ,2343,2510,4853,1024,5
Insiza-3, ZW160503 ,2458,2801,5259,1096,5
Insiza-4, ZW160504 ,2514,2759,5273,1059,5
Insiza-5, ZW160505 ,2093,2349,4442,955,5
Insiza-6, ZW160506 ,1751,2010,3761,811,5
Insiza-7, ZW160507 ,1895,2196,4091,815,5
Insiza-8, ZW160508 ,438,414,852,150,6
Insiza-9, ZW160509 ,2112,2338,4450,949,5
Insiza-10, ZW160510 ,1120,1160,2280,444,5
Insiza-11, ZW160511 ,1226,1488,2714,537,5
Insiza-12, ZW160512 ,1126,1137,2263,452,5
Insiza-13, ZW160513 ,1677,1615,3292,784,4
Insiza-14, ZW160514 ,1487,1054,2541,794,3
Insiza-15, ZW160515 ,2626,2546,5172,1422,4
Insiza-16, ZW160516 ,1750,1371,3121,652,5
Insiza-17, ZW160517 ,2622,2880,5502,1130,5
Insiza-18, ZW160518 ,1610,1725,3335,645,5
Insiza-19, ZW160519 ,3797,3895,7692,1488,5
Insiza-20, ZW160520 ,3975,4393,8368,1585,5
Insiza-21, ZW160521 ,3369,3281,6650,1293,5
Insiza-22, ZW160522 ,2814,2820,5634,1221,5
Insiza-23, ZW160523 ,2477,1902,4379,1312,3
Matobo-1, ZW160601 ,1833,2149,3982,854,5
Matobo-2, ZW160602 ,2999,3079,6078,1387,4
Matobo-3, ZW160603 ,1674,1847,3521,827,4
Matobo-4, ZW160604 ,2322,2614,4936,999,5
Matobo-5, ZW160605 ,2157,2511,4668,930,5
Matobo-6, ZW160606 ,2399,2959,5358,1046,5
Matobo-7, ZW160607 ,2253,2618,4871,1043,5
Matobo-8, ZW160608 ,1992,2322,4314,896,5
Matobo-9, ZW160609 ,1540,1660,3200,665,5
Matobo-10, ZW160610 ,1575,1921,3496,724,5
Matobo-11, ZW160611 ,1547,1811,3358,709,5
Matobo-12, ZW160612 ,1983,2158,4141,854,5
Matobo-13, ZW160613 ,1684,1996,3680,872,4
Matobo-14, ZW160614 ,1952,2374,4326,980,4
Matobo-15, ZW160615 ,2494,2595,5089,1082,5
Matobo-16, ZW160616 ,2230,2486,4716,945,5
Matobo-17, ZW160617 ,2053,2215,4268,918,5
Matobo-18, ZW160618 ,1646,1875,3521,722,5
Matobo-19, ZW160619 ,2640,3080,5720,1339,4
Matobo-20, ZW160620 ,49,16,65,25,3
Matobo-21, ZW160621 ,673,433,1106,277,4
Matobo-22, ZW160622 ,438,200,638,214,3
Matobo-23, ZW160623 ,566,409,975,249,4
Matobo-24, ZW160624 ,1157,885,2042,539,4
Matobo-25, ZW160625 ,3162,2760,5922,1653,4
Umzingwane-1, ZW160701 ,1659,1681,3340,652,5
Umzingwane-2, ZW160702 ,1696,1909,3605,835,4
Umzingwane-3, ZW160703 ,2609,2738,5347,1140,5
Umzingwane-4, ZW160704 ,1963,2024,3987,884,5
Umzingwane-5, ZW160705 ,1989,2325,4314,913,5
Umzingwane-6, ZW160706 ,1989,2157,4146,942,4
Umzingwane-7, ZW160707 ,1435,1515,2950,643,5
Umzingwane-8, ZW160708 ,1353,1423,2776,571,5
Umzingwane-9, ZW160709 ,1093,1196,2289,494,5
Umzingwane-10, ZW160710 ,523,615,1138,244,5
Umzingwane-11, ZW160711 ,1033,1124,2157,476,5
Umzingwane-12, ZW160712 ,1812,1918,3730,806,5
Umzingwane-13, ZW160713 ,734,949,1683,306,6
Umzingwane-14, ZW160714 ,1759,1545,3304,797,4
Umzingwane-15, ZW160715 ,277,170,447,139,3
Umzingwane-16, ZW160716 ,1647,1692,3339,923,4
Umzingwane-17, ZW160717 ,1457,1473,2930,1008,3
Umzingwane-18, ZW160718 ,2495,2180,4675,1140,4
Umzingwane-19, ZW160719 ,2259,1986,4245,1054,4
Umzingwane-20, ZW160720 ,1014,1094,2108,483,4
Chirumhanzu-1, ZW170101 ,1823,2207,4030,1042,4
Chirumhanzu-2, ZW170102 ,1711,2114,3825,903,4
Chirumhanzu-3, ZW170103 ,1870,2385,4255,1030,4
Chirumhanzu-4, ZW170104 ,990,1190,2180,566,4
Chirumhanzu-5, ZW170105 ,1224,1551,2775,694,4
Chirumhanzu-6, ZW170106 ,1577,1909,3486,846,4
Chirumhanzu-7, ZW170107 ,1314,1468,2782,700,4
Chirumhanzu-8, ZW170108 ,1487,1844,3331,845,4
Chirumhanzu-9, ZW170109 ,2375,2844,5219,1320,4
Chirumhanzu-10, ZW170110 ,561,609,1170,299,4
Chirumhanzu-11, ZW170111 ,1700,1787,3487,753,5
Chirumhanzu-12, ZW170112 ,2548,2310,4858,1121,4
Chirumhanzu-13, ZW170113 ,614,678,1292,365,4
Chirumhanzu-14, ZW170114 ,959,1117,2076,575,4
Chirumhanzu-15, ZW170115 ,2120,2090,4210,936,5
Chirumhanzu-16, ZW170116 ,583,484,1067,332,3
Chirumhanzu-17, ZW170117 ,906,977,1883,570,3
Chirumhanzu-18, ZW170118 ,890,954,1844,407,5
Chirumhanzu-19, ZW170119 ,1927,1944,3871,836,5
Chirumhanzu-20, ZW170120 ,4129,4174,8303,1880,4
Chirumhanzu-21, ZW170121 ,847,977,1824,464,4
Chirumhanzu-22, ZW170122 ,2163,2163,4326,1019,4
Chirumhanzu-23, ZW170123 ,1496,1818,3314,812,4
Chirumhanzu-24, ZW170124 ,937,1106,2043,540,4
Chirumhanzu-25, ZW170125 ,1660,1976,3636,881,4
Gokwe North-1, ZW170201 ,2967,3338,6305,1308,5
Gokwe North-2, ZW170202 ,7629,8446,16075,3227,5
Gokwe North-3, ZW170203 ,6526,7272,13798,1714,8
Gokwe North-4, ZW170204 ,4803,5253,10056,1962,5
Gokwe North-5, ZW170205 ,4224,4597,8821,1751,5
Gokwe North-6, ZW170206 ,2369,2510,4879,984,5
Gokwe North-7, ZW170207 ,4166,4285,8451,1712,5
Gokwe North-8, ZW170208 ,3796,4087,7883,1562,5
Gokwe North-9, ZW170209 ,4937,5112,10049,2074,5
Gokwe North-10, ZW170210 ,2349,2657,5006,1040,5
Gokwe North-11, ZW170211 ,3991,4242,8233,1826,5
Gokwe North-12, ZW170212 ,3425,3717,7142,1592,5
Gokwe North-13, ZW170213 ,3022,3287,6309,1346,5
Gokwe North-14, ZW170214 ,3169,3530,6699,1470,5
Gokwe North-15, ZW170215 ,3216,3499,6715,1482,5
Gokwe North-16, ZW170216 ,2173,2270,4443,983,5
Gokwe North-17, ZW170217 ,2653,2640,5293,1092,5
Gokwe North-18, ZW170218 ,2578,2761,5339,1134,5
Gokwe North-19, ZW170219 ,2892,3120,6012,1289,5
Gokwe North-20, ZW170220 ,2514,2575,5089,942,5
Gokwe North-21, ZW170221 ,2064,2132,4196,855,5
Gokwe North-22, ZW170222 ,4340,3847,8187,1613,5
Gokwe North-23, ZW170223 ,3183,3523,6706,1363,5
Gokwe North-24, ZW170224 ,1109,1076,2185,421,5
Gokwe North-25, ZW170225 ,1633,1633,3266,643,5
Gokwe North-26, ZW170226 ,1329,1347,2676,558,5
Gokwe North-27, ZW170227 ,2801,2980,5781,1056,6
Gokwe North-28, ZW170228 ,3846,4147,7993,1577,5
Gokwe North-29, ZW170229 ,1741,1937,3678,811,5
Gokwe North-30, ZW170230 ,3102,3434,6536,1379,5
Gokwe North-31, ZW170231 ,3306,3867,7173,1531,5
Gokwe North-32, ZW170232 ,1340,1411,2751,532,5
Gokwe North-33, ZW170233 ,2717,2948,5665,1110,5
Gokwe North-34, ZW170234 ,2963,3223,6186,1201,5
Gokwe North-35, ZW170235 ,3410,3670,7080,1507,5
Gokwe North-36, ZW170236 ,5898,6422,12320,2937,4
Gokwe South-1, ZW170301 ,5152,5436,10588,2231,5
Gokwe South-2, ZW170302 ,3804,4102,7906,1573,5
Gokwe South-3, ZW170303 ,1574,1872,3446,691,5
Gokwe South-4, ZW170304 ,3897,4298,8195,1653,5
Gokwe South-5, ZW170305 ,5588,6280,11868,2432,5
Gokwe South-6, ZW170306 ,3366,3772,7138,1460,5
Gokwe South-7, ZW170307 ,3035,3319,6354,1342,5
Gokwe South-8, ZW170308 ,4337,4640,8977,1867,5
Gokwe South-9, ZW170309 ,8883,9652,18535,3736,5
Gokwe South-10, ZW170310 ,5591,6371,11962,2445,5
Gokwe South-11, ZW170311 ,5950,6565,12515,2653,5
Gokwe South-12, ZW170312 ,5240,5666,10906,2226,5
Gokwe South-13, ZW170313 ,6442,6915,13357,2632,5
Gokwe South-14, ZW170314 ,4951,5153,10104,2024,5
Gokwe South-15, ZW170315 ,6339,6953,13292,2698,5
Gokwe South-16, ZW170316 ,4926,5127,10053,2041,5
Gokwe South-17, ZW170317 ,3114,3210,6324,1267,5
Gokwe South-18, ZW170318 ,4330,4709,9039,1908,5
Gokwe South-19, ZW170319 ,6795,7194,13989,2877,5
Gokwe South-20, ZW170320 ,3094,3463,6557,1344,5
Gokwe South-21, ZW170321 ,4788,5084,9872,2106,5
Gokwe South-22, ZW170322 ,3553,3716,7269,1525,5
Gokwe South-23, ZW170323 ,7005,7340,14345,3083,5
Gokwe South-24, ZW170324 ,9363,9353,18716,4080,5
Gokwe South-25, ZW170325 ,5369,5612,10981,2311,5
Gokwe South-26, ZW170326 ,2995,3326,6321,1215,5
Gokwe South-27, ZW170327 ,4978,5223,10201,1956,5
Gokwe South-28, ZW170328 ,1693,1629,3322,644,5
Gokwe South-29, ZW170329 ,3285,3647,6932,1391,5
Gokwe South-30, ZW170330 ,2033,2188,4221,845,5
Gokwe South-31, ZW170331 ,2005,2219,4224,819,5
Gokwe South-32, ZW170332 ,2251,2390,4641,1030,5
Gokwe South-33, ZW170333 ,2553,2547,5100,1119,5
Gweru-1, ZW170401 ,5466,5860,11326,2738,9
Gweru-2, ZW170402 ,7773,8738,16511,3930,9
Gweru-3, ZW170403 ,4690,5535,10225,2291,9
Gweru-4, ZW170404 ,5433,6516,11949,2827,9
Gweru-5, ZW170405 ,7705,8411,16116,4411,8
Gweru-6, ZW170406 ,5755,6422,12177,3049,9
Gweru-7, ZW170407 ,5464,6323,11787,2979,8
Gweru-8, ZW170408 ,9719,11160,20879,5166,9
Gweru-9, ZW170409 ,6343,6656,12999,3271,8
Gweru-10, ZW170410 ,7979,9109,17088,4280,8
Gweru-11, ZW170411 ,4773,5741,10514,2639,9
Gweru-12, ZW170412 ,5477,6552,12029,2876,8
Gweru-13, ZW170413 ,5219,6024,11243,2849,9
Gweru-14, ZW170414 ,7958,7064,15022,3643,8
Gweru-15, ZW170415 ,7916,8874,16790,4225,8
Gweru-16, ZW170416 ,7317,7596,14913,3655,8
Gweru-17, ZW170417 ,5461,6097,11558,2831,9
Gweru-18, ZW170418 ,6889,7284,14173,3418,9
Gweru-19, ZW170419 ,2040,2022,4062,827,5
Kwekwe-1, ZW170501 ,7689,7895,15584,3736,9
Kwekwe-2, ZW170502 ,8796,8974,17770,4779,7
Kwekwe-3, ZW170503 ,7629,7623,15252,3590,9
Kwekwe-4, ZW170504 ,4466,4342,8808,2218,8
Kwekwe-5, ZW170505 ,6415,6907,13322,2982,9
Kwekwe-6, ZW170506 ,5071,5128,10199,2280,9
Kwekwe-7, ZW170507 ,5159,5567,10726,2490,9
Kwekwe-8, ZW170508 ,7642,8332,15974,3714,9
Kwekwe-9, ZW170509 ,3629,3897,7526,1821,8
Kwekwe-10, ZW170510 ,4977,5398,10375,2370,9
Kwekwe-11, ZW170511 ,8981,9782,18763,4246,9
Kwekwe-12, ZW170512 ,5549,6126,11675,2592,9
Kwekwe-13, ZW170513 ,4875,5379,10254,2194,9
Kwekwe-14, ZW170514 ,6281,6642,12923,2938,9
Kwekwe-15, ZW170515 ,3463,3443,6906,1450,5
Kwekwe-16, ZW170516 ,2010,2283,4293,817,5
Kwekwe-17, ZW170517 ,3724,4087,7811,1535,5
Kwekwe-18, ZW170518 ,1094,1101,2195,587,4
Kwekwe-19, ZW170519 ,1232,1318,2550,618,4
Kwekwe-20, ZW170520 ,2730,2799,5529,1282,4
Kwekwe-21, ZW170521 ,4647,5035,9682,2045,5
Kwekwe-22, ZW170522 ,4788,4894,9682,1933,5
Kwekwe-23, ZW170523 ,722,803,1525,292,5
Kwekwe-24, ZW170524 ,3131,3297,6428,1340,5
Kwekwe-25, ZW170525 ,2454,2645,5099,1096,5
Kwekwe-26, ZW170526 ,931,957,1888,387,5
Kwekwe-27, ZW170527 ,2448,2550,4998,1002,5
Kwekwe-28, ZW170528 ,992,1034,2026,397,5
Kwekwe-29, ZW170529 ,1404,1427,2831,579,5
Kwekwe-30, ZW170530 ,3260,2925,6185,1504,4
Kwekwe-31, ZW170531 ,5586,4646,10232,2530,4
Kwekwe-32, ZW170532 ,1822,1853,3675,823,5
Kwekwe-33, ZW170533 ,1778,1826,3604,719,5
Mberengwa-1, ZW170601 ,2310,2217,4527,940,5
Mberengwa-2, ZW170602 ,6084,5571,11655,2543,5
Mberengwa-3, ZW170603 ,2676,3149,5825,1262,5
Mberengwa-4, ZW170604 ,2855,3264,6119,1373,5
Mberengwa-5, ZW170605 ,3221,3880,7101,1459,5
Mberengwa-6, ZW170606 ,3907,4863,8770,1856,5
Mberengwa-7, ZW170607 ,1715,2013,3728,829,5
Mberengwa-8, ZW170608 ,2181,2518,4699,997,5
Mberengwa-9, ZW170609 ,1673,1892,3565,732,5
Mberengwa-10, ZW170610 ,1808,1910,3718,769,5
Mberengwa-11, ZW170611 ,1755,1974,3729,790,5
Mberengwa-12, ZW170612 ,2024,2273,4297,922,5
Mberengwa-13, ZW170613 ,2039,2290,4329,895,5
Mberengwa-14, ZW170614 ,1721,2028,3749,696,5
Mberengwa-15, ZW170615 ,1839,2071,3910,806,5
Mberengwa-16, ZW170616 ,1801,2160,3961,838,5
Mberengwa-17, ZW170617 ,2155,2438,4593,985,5
Mberengwa-18, ZW170618 ,3575,4360,7935,1723,5
Mberengwa-19, ZW170619 ,2878,3559,6437,1299,5
Mberengwa-20, ZW170620 ,1606,2014,3620,755,5
Mberengwa-21, ZW170621 ,2210,2571,4781,956,5
Mberengwa-22, ZW170622 ,1813,2321,4134,861,5
Mberengwa-23, ZW170623 ,2082,2631,4713,999,5
Mberengwa-24, ZW170624 ,2038,2458,4496,897,5
Mberengwa-25, ZW170625 ,1572,2010,3582,752,5
Mberengwa-26, ZW170626 ,2711,3267,5978,1216,5
Mberengwa-27, ZW170627 ,1619,2025,3644,715,5
Mberengwa-28, ZW170628 ,1751,2113,3864,792,5
Mberengwa-29, ZW170629 ,2535,2868,5403,1080,5
Mberengwa-30, ZW170630 ,2073,2479,4552,938,5
Mberengwa-31, ZW170631 ,3138,3794,6932,1490,5
Mberengwa-32, ZW170632 ,2817,3163,5980,1280,5
Mberengwa-33, ZW170633 ,1357,1733,3090,662,5
Mberengwa-34, ZW170634 ,1485,1668,3153,660,5
Mberengwa-35, ZW170635 ,2739,2631,5370,1073,5
Mberengwa-36, ZW170636 ,4625,4070,8695,1695,5
Mberengwa-37, ZW170637 ,697,833,1530,317,5
Shurugwi-1, ZW170701 ,2261,2314,4575,1027,8
Shurugwi-2, ZW170702 ,2112,2186,4298,970,9
Shurugwi-3, ZW170703 ,724,703,1427,393,8
Shurugwi-4, ZW170704 ,802,787,1589,375,9
Shurugwi-5, ZW170705 ,2381,2734,5115,1187,9
Shurugwi-6, ZW170706 ,1835,1664,3499,777,10
Shurugwi-7, ZW170707 ,1658,1738,3396,797,8
Shurugwi-8, ZW170708 ,2529,2760,5289,1200,9
Shurugwi-9, ZW170709 ,2659,3002,5661,1348,8
Shurugwi-10, ZW170710 ,3611,4058,7669,1896,8
Shurugwi-11, ZW170711 ,3597,4090,7687,1762,9
Shurugwi-12, ZW170712 ,3513,3920,7433,1776,8
Shurugwi-13, ZW170713 ,2986,2918,5904,1476,8
Shurugwi-14, ZW170714 ,1260,1483,2743,679,4
Shurugwi-15, ZW170715 ,1406,1586,2992,696,4
Shurugwi-16, ZW170716 ,1411,1307,2718,567,5
Shurugwi-17, ZW170717 ,2035,1582,3617,817,4
Shurugwi-18, ZW170718 ,3408,2926,6334,1448,4
Shurugwi-19, ZW170719 ,2353,1979,4332,777,6
Shurugwi-20, ZW170720 ,1376,1365,2741,589,5
Shurugwi-21, ZW170721 ,2608,2771,5379,1143,5
Shurugwi-22, ZW170722 ,264,238,502,100,5
Shurugwi-23, ZW170723 ,747,866,1613,316,5
Shurugwi-24, ZW170724 ,1598,1805,3403,785,4
Zvishavane-1, ZW170801 ,2365,2634,4999,1238,8
Zvishavane-2, ZW170802 ,2323,2684,5007,1202,8
Zvishavane-3, ZW170803 ,3542,3953,7495,2020,8
Zvishavane-4, ZW170804 ,4153,4725,8878,2070,9
Zvishavane-5, ZW170805 ,2276,2222,4498,994,9
Zvishavane-6, ZW170806 ,3565,4184,7749,1797,9
Zvishavane-7, ZW170807 ,5081,5739,10820,2536,9
Zvishavane-8, ZW170808 ,5929,6474,12403,3353,8
Zvishavane-9, ZW170809 ,2073,2165,4238,1155,8
Zvishavane-10, ZW170810 ,4047,4437,8484,2098,9
Zvishavane-11, ZW170811 ,1366,1633,2999,651,5
Zvishavane-12, ZW170812 ,1840,1825,3665,750,5
Zvishavane-13, ZW170813 ,2014,2139,4153,867,5
Zvishavane-14, ZW170814 ,3192,3007,6199,1314,5
Zvishavane-15, ZW170815 ,2347,2660,5007,1106,5
Zvishavane-16, ZW170816 ,1836,2105,3941,841,5
Zvishavane-17, ZW170817 ,2624,2993,5617,1191,5
Zvishavane-18, ZW170818 ,2318,2549,4867,945,5
Zvishavane-19, ZW170819 ,2395,1958,4353,1040,4
Redcliff-1, ZW172301 ,1154,1251,2405,656,4
Redcliff-2, ZW172302 ,1738,1745,3483,954,4
Redcliff-3, ZW172303 ,1323,1379,2702,692,4
Redcliff-4, ZW172304 ,1943,2118,4061,1023,4
Redcliff-5, ZW172305 ,3405,3741,7146,1970,4
Redcliff-6, ZW172306 ,4579,5004,9583,2493,4
Redcliff-7, ZW172307 ,863,987,1850,494,4
Redcliff-8, ZW172308 ,938,1026,1964,520,4
Redcliff-9, ZW172309 ,1254,1476,2730,656,4
Gokwe South Urban-1, ZW172901 ,1352,1732,3084,797,4
Gokwe South Urban-2, ZW172902 ,1933,2421,4354,1292,3
Gokwe South Urban-3, ZW172903 ,2035,2370,4405,1036,4
Gokwe South Urban-4, ZW172904 ,1036,1197,2233,637,4
Gokwe South Urban-5, ZW172905 ,3421,4245,7666,2080,4
Gokwe South Urban-6, ZW172906 ,1131,1263,2394,553,4
Bikita-1, ZW180101 ,1693,1953,3646,738,5
Bikita-2, ZW180102 ,3981,4911,8892,1957,5
Bikita-3, ZW180103 ,3228,3978,7206,1704,4
Bikita-4, ZW180104 ,2310,2932,5242,1260,4
Bikita-5, ZW180105 ,3017,3542,6559,1554,4
Bikita-6, ZW180106 ,1827,2397,4224,975,4
Bikita-7, ZW180107 ,2349,2709,5058,1210,4
Bikita-8, ZW180108 ,2718,3407,6125,1456,4
Bikita-9, ZW180109 ,3182,3786,6968,1638,4
Bikita-10, ZW180110 ,2392,2882,5274,1215,4
Bikita-11, ZW180111 ,3481,4009,7490,1740,4
Bikita-12, ZW180112 ,1951,2283,4234,977,4
Bikita-13, ZW180113 ,4764,5917,10681,2622,4
Bikita-14, ZW180114 ,2904,3533,6437,1488,4
Bikita-15, ZW180115 ,2988,3674,6662,1567,4
Bikita-16, ZW180116 ,3794,4688,8482,1946,4
Bikita-17, ZW180117 ,2113,2623,4736,1156,4
Bikita-18, ZW180118 ,2222,2532,4754,1105,4
Bikita-19, ZW180119 ,2062,2448,4510,1082,4
Bikita-20, ZW180120 ,3346,4127,7473,1779,4
Bikita-21, ZW180121 ,1850,2324,4174,976,4
Bikita-22, ZW180122 ,2645,3132,5777,1370,4
Bikita-23, ZW180123 ,147,139,286,63,5
Bikita-24, ZW180124 ,2013,2490,4503,1047,4
Bikita-25, ZW180125 ,2002,2257,4259,992,4
Bikita-26, ZW180126 ,1905,2111,4016,867,5
Bikita-27, ZW180127 ,228,122,350,169,2
Bikita-28, ZW180128 ,843,895,1738,343,5
Bikita-29, ZW180129 ,749,752,1501,324,5
Bikita-30, ZW180130 ,364,269,633,211,3
Bikita-31, ZW180131 ,2810,2915,5725,1268,5
Bikita-32, ZW180132 ,1812,2276,4088,968,4
Chiredzi-1, ZW180201 ,1944,2242,4186,952,4
Chiredzi-2, ZW180202 ,1783,2247,4030,890,5
Chiredzi-3, ZW180203 ,1463,1860,3323,725,5
Chiredzi-4, ZW180204 ,2553,3098,5651,1305,4
Chiredzi-5, ZW180205 ,1957,2409,4366,986,4
Chiredzi-6, ZW180206 ,3421,4128,7549,1450,5
Chiredzi-7, ZW180207 ,3394,4392,7786,1557,5
Chiredzi-8, ZW180208 ,3541,4364,7905,1640,5
Chiredzi-9, ZW180209 ,1627,2016,3643,674,5
Chiredzi-10, ZW180210 ,4560,5458,10018,1960,5
Chiredzi-11, ZW180211 ,5040,6565,11605,2337,5
Chiredzi-12, ZW180212 ,222,194,416,79,5
Chiredzi-13, ZW180213 ,1831,2266,4097,835,5
Chiredzi-14, ZW180214 ,3777,4876,8653,1848,5
Chiredzi-15, ZW180215 ,3714,4753,8467,1723,5
Chiredzi-16, ZW180216 ,9888,10795,20683,4378,5
Chiredzi-17, ZW180217 ,8920,9936,18856,4043,5
Chiredzi-18, ZW180218 ,6651,6603,13254,3794,4
Chiredzi-19, ZW180219 ,6563,5720,12283,3474,4
Chiredzi-20, ZW180220 ,8770,9788,18558,3874,5
Chiredzi-21, ZW180221 ,5649,4807,10456,3040,3
Chiredzi-22, ZW180222 ,2918,3413,6331,1378,5
Chiredzi-23, ZW180223 ,2528,2903,5431,1129,5
Chiredzi-24, ZW180224 ,10984,11394,22378,4634,5
Chiredzi-25, ZW180225 ,1383,1724,3107,696,5
Chiredzi-26, ZW180226 ,1476,1544,3020,669,5
Chiredzi-27, ZW180227 ,3411,3242,6653,1946,3
Chiredzi-28, ZW180228 ,7546,6877,14423,4216,3
Chiredzi-29, ZW180229 ,3125,2726,5851,1476,4
Chiredzi-30, ZW180230 ,5098,4084,9182,2829,3
Chiredzi-31, ZW180231 ,4614,3863,8477,2752,3
Chiredzi-32, ZW180232 ,3034,3170,6204,1576,4
Chivi-1, ZW180301 ,2648,3063,5711,1204,5
Chivi-2, ZW180302 ,2718,3222,5940,1315,5
Chivi-3, ZW180303 ,2491,2716,5207,1111,5
Chivi-4, ZW180304 ,1825,2216,4041,879,5
Chivi-5, ZW180305 ,1844,2175,4019,880,5
Chivi-6, ZW180306 ,1032,1240,2272,521,4
Chivi-7, ZW180307 ,1406,1634,3040,641,5
Chivi-8, ZW180308 ,1856,2166,4022,864,5
Chivi-9, ZW180309 ,1865,2239,4104,915,5
Chivi-10, ZW180310 ,1847,2054,3901,856,5
Chivi-11, ZW180311 ,1997,2469,4466,996,5
Chivi-12, ZW180312 ,2391,2849,5240,1131,5
Chivi-13, ZW180313 ,1615,2019,3634,844,4
Chivi-14, ZW180314 ,2730,3174,5904,1201,5
Chivi-15, ZW180315 ,2271,2697,4968,1072,5
Chivi-16, ZW180316 ,3657,4179,7836,1685,5
Chivi-17, ZW180317 ,1991,2467,4458,983,5
Chivi-18, ZW180318 ,1913,2303,4216,945,5
Chivi-19, ZW180319 ,2947,3475,6422,1395,5
Chivi-20, ZW180320 ,2804,3440,6244,1366,5
Chivi-21, ZW180321 ,2332,2891,5223,1079,5
Chivi-22, ZW180322 ,2517,3019,5536,1190,5
Chivi-23, ZW180323 ,2268,2772,5040,1141,4
Chivi-24, ZW180324 ,2247,2737,4984,1120,5
Chivi-25, ZW180325 ,4834,6059,10893,2542,4
Chivi-26, ZW180326 ,3553,4411,7964,1759,5
Chivi-27, ZW180327 ,2191,2518,4709,925,5
Chivi-28, ZW180328 ,3540,4066,7606,1600,5
Chivi-29, ZW180329 ,2276,2446,4722,925,5
Chivi-30, ZW180330 ,1974,2472,4446,1168,4
Chivi-31, ZW180331 ,1734,2055,3789,865,4
Chivi-32, ZW180332 ,2588,3132,5720,1264,5
Gutu-1, ZW180401 ,5184,5185,10369,2224,5
Gutu-2, ZW180402 ,1559,1848,3407,828,4
Gutu-3, ZW180403 ,2165,2373,4538,863,5
Gutu-4, ZW180404 ,1232,1271,2503,540,5
Gutu-5, ZW180405 ,1995,2281,4276,1024,4
Gutu-6, ZW180406 ,2202,2652,4854,1200,4
Gutu-7, ZW180407 ,2952,3201,6153,1427,4
Gutu-8, ZW180408 ,4007,4796,8803,2057,4
Gutu-9, ZW180409 ,2521,3062,5583,1361,4
Gutu-10, ZW180410 ,2809,3388,6197,1544,4
Gutu-11, ZW180411 ,2786,3375,6161,1557,4
Gutu-12, ZW180412 ,3108,3637,6745,1649,4
Gutu-13, ZW180413 ,3422,4086,7508,1872,4
Gutu-14, ZW180414 ,1240,1533,2773,644,4
Gutu-15, ZW180415 ,5091,6027,11118,2597,4
Gutu-16, ZW180416 ,3294,3979,7273,1710,4
Gutu-17, ZW180417 ,1367,1644,3011,757,4
Gutu-18, ZW180418 ,2259,2466,4725,1064,4
Gutu-19, ZW180419 ,1898,2098,3996,957,4
Gutu-20, ZW180420 ,782,733,1515,328,5
Gutu-21, ZW180421 ,1832,2221,4053,1071,4
Gutu-22, ZW180422 ,1701,1969,3670,872,4
Gutu-23, ZW180423 ,3461,4109,7570,1745,4
Gutu-24, ZW180424 ,2283,2805,5088,1232,4
Gutu-25, ZW180425 ,1809,2321,4130,1022,4
Gutu-26, ZW180426 ,2069,2460,4529,1085,4
Gutu-27, ZW180427 ,2361,2853,5214,1201,4
Gutu-28, ZW180428 ,2083,2600,4683,1086,4
Gutu-29, ZW180429 ,1737,1901,3638,796,5
Gutu-30, ZW180430 ,1621,1907,3528,851,4
Gutu-31, ZW180431 ,2193,2571,4764,1196,4
Gutu-32, ZW180432 ,4176,4377,8553,1888,5
Gutu-33, ZW180433 ,704,711,1415,370,4
Gutu-34, ZW180434 ,3636,3337,6973,1814,4
Gutu-35, ZW180435 ,1503,1716,3219,827,4
Gutu-36, ZW180436 ,2134,2482,4616,1086,4
Gutu-37, ZW180437 ,2734,3181,5915,1375,4
Gutu-38, ZW180438 ,721,839,1560,372,4
Gutu-39, ZW180439 ,993,1181,2174,548,4
Gutu-40, ZW180440 ,1300,1616,2916,693,4
Gutu-41, ZW180441 ,1752,2065,3817,911,4
Masvingo-1, ZW180501 ,4872,5617,10489,2844,7
Masvingo-2, ZW180502 ,5876,6971,12847,3400,8
Masvingo-3, ZW180503 ,7633,8774,16407,4412,8
Masvingo-4, ZW180504 ,5838,7005,12843,3349,8
Masvingo-5, ZW180505 ,7070,8121,15191,4145,8
Masvingo-6, ZW180506 ,9551,10560,20111,5037,8
Masvingo-7, ZW180507 ,11467,13212,24679,6713,8
Masvingo-8, ZW180508 ,5210,5312,10522,2458,8
Masvingo-9, ZW180509 ,5862,6375,12237,2605,9
Masvingo-10, ZW180510 ,6866,7357,14223,3083,9
Masvingo-11, ZW180511 ,2451,2943,5394,1173,5
Masvingo-12, ZW180512 ,3368,4150,7518,1639,5
Masvingo-13, ZW180513 ,3855,4695,8550,1856,5
Masvingo-14, ZW180514 ,2553,2957,5510,1237,5
Masvingo-15, ZW180515 ,2564,3079,5643,1231,5
Masvingo-16, ZW180516 ,3752,4605,8357,1815,5
Masvingo-17, ZW180517 ,3158,3735,6893,1577,4
Masvingo-18, ZW180518 ,3334,3939,7273,1635,4
Masvingo-19, ZW180519 ,1392,1675,3067,717,4
Masvingo-20, ZW180520 ,2028,2564,4592,1003,5
Masvingo-21, ZW180521 ,1780,2021,3801,803,5
Masvingo-22, ZW180522 ,3638,4316,7954,1602,5
Masvingo-23, ZW180523 ,2077,2228,4305,958,5
Masvingo-24, ZW180524 ,2302,2893,5195,1175,4
Masvingo-25, ZW180525 ,1421,1715,3136,671,5
Masvingo-26, ZW180526 ,2712,3147,5859,1360,4
Masvingo-27, ZW180527 ,1266,1510,2776,583,5
Masvingo-28, ZW180528 ,2598,2998,5596,1200,5
Masvingo-29, ZW180529 ,3282,3879,7161,1586,5
Masvingo-30, ZW180530 ,7111,7865,14976,2980,5
Masvingo-31, ZW180531 ,1275,1347,2622,531,5
Masvingo-32, ZW180532 ,4054,3869,7923,1777,5
Masvingo-33, ZW180533 ,2751,2533,5284,1482,4
Masvingo-34, ZW180534 ,2810,3391,6201,1249,5
Masvingo-35, ZW180535 ,2654,2497,5151,1346,4
Mwenezi-1, ZW180601 ,2434,3155,5589,1230,5
Mwenezi-2, ZW180602 ,2358,2930,5288,1065,5
Mwenezi-3, ZW180603 ,3529,4457,7986,1622,5
Mwenezi-4, ZW180604 ,2478,2858,5336,1169,5
Mwenezi-5, ZW180605 ,4568,5723,10291,2134,5
Mwenezi-6, ZW180606 ,1960,2386,4346,840,5
Mwenezi-7, ZW180607 ,2742,3412,6154,1261,5
Mwenezi-8, ZW180608 ,2918,3662,6580,1282,5
Mwenezi-9, ZW180609 ,3175,3859,7034,1443,5
Mwenezi-10, ZW180610 ,3347,4361,7708,1528,5
Mwenezi-11, ZW180611 ,2641,3553,6194,1255,5
Mwenezi-12, ZW180612 ,2345,2887,5232,1028,5
Mwenezi-13, ZW180613 ,14083,14974,29057,5801,5
Mwenezi-14, ZW180614 ,4777,5318,10095,1898,5
Mwenezi-15, ZW180615 ,4518,4693,9211,2057,5
Mwenezi-16, ZW180616 ,7313,7776,15089,3201,5
Mwenezi-17, ZW180617 ,9902,11453,21355,4073,5
Mwenezi-18, ZW180618 ,1717,2001,3718,1080,3
Zaka-1, ZW180701 ,1634,1927,3561,765,5
Zaka-2, ZW180702 ,2208,2641,4849,1123,4
Zaka-3, ZW180703 ,2713,3297,6010,1311,5
Zaka-4, ZW180704 ,3876,4663,8539,1905,5
Zaka-5, ZW180705 ,2419,2952,5371,1227,4
Zaka-6, ZW180706 ,2105,2466,4571,1041,4
Zaka-7, ZW180707 ,1318,1530,2848,620,5
Zaka-8, ZW180708 ,3294,4006,7300,1685,4
Zaka-9, ZW180709 ,2538,3002,5540,1251,4
Zaka-10, ZW180710 ,2569,3045,5614,1307,4
Zaka-11, ZW180711 ,2719,3407,6126,1316,5
Zaka-12, ZW180712 ,2519,2947,5466,1235,4
Zaka-13, ZW180713 ,1969,2298,4267,965,4
Zaka-14, ZW180714 ,2106,2552,4658,1048,4
Zaka-15, ZW180715 ,3894,4549,8443,1866,5
Zaka-16, ZW180716 ,2061,2641,4702,1059,4
Zaka-17, ZW180717 ,1455,1636,3091,708,4
Zaka-18, ZW180718 ,2598,3130,5728,1183,5
Zaka-19, ZW180719 ,4440,5846,10286,2568,4
Zaka-20, ZW180720 ,2508,3062,5570,1208,5
Zaka-21, ZW180721 ,2463,2924,5387,1155,5
Zaka-22, ZW180722 ,1651,1921,3572,785,5
Zaka-23, ZW180723 ,1842,2223,4065,853,5
Zaka-24, ZW180724 ,2730,3418,6148,1290,5
Zaka-25, ZW180725 ,2734,3212,5946,1317,5
Zaka-26, ZW180726 ,1997,2472,4469,986,5
Zaka-27, ZW180727 ,2821,3252,6073,1291,5
Zaka-28, ZW180728 ,2541,3205,5746,1266,5
Zaka-29, ZW180729 ,1607,1956,3563,789,5
Zaka-30, ZW180730 ,2228,2664,4892,1066,5
Zaka-31, ZW180731 ,2291,2776,5067,1090,5
Zaka-32, ZW180732 ,2305,2859,5164,1132,5
Zaka-33, ZW180733 ,2046,2508,4554,1001,5
Zaka-34, ZW180734 ,1781,2139,3920,838,5
Chiredzi Urban-1, ZW182201 ,615,580,1195,241,5
Chiredzi Urban-2, ZW182202 ,1223,1276,2499,628,4
Chiredzi Urban-3, ZW182203 ,2226,2509,4735,1299,4
Chiredzi Urban-4, ZW182204 ,2957,3456,6413,1958,3
Chiredzi Urban-5, ZW182205 ,2510,2786,5296,1566,3
Chiredzi Urban-6, ZW182206 ,1441,1640,3081,871,4
Chiredzi Urban-7, ZW182207 ,1542,1609,3151,844,4
Chiredzi Urban-8, ZW182208 ,1967,2257,4224,1083,4
